Mun;2017;2018;2019;2020;2021;Total
110001 Alta Floresta D'Oeste;0;0;7050;33908;55066;96024
110037 Alto Alegre dos Parecis;0;0;0;0;0;0
110040 Alto Paraíso;0;0;551;1222;1201;2974
110034 Alvorada D'Oeste;0;0;0;0;0;0
110002 Ariquemes;2031;12647;56519;34655;56832;162684
110045 Buritis;0;0;3245;49005;69794;122044
110003 Cabixi;0;0;0;0;0;0
110060 Cacaulândia;0;0;0;0;0;0
110004 Cacoal;22;15648;47823;23378;370;87241
110070 Campo Novo de Rondônia;0;0;0;0;0;0
110080 Candeias do Jamari;0;0;0;0;0;0
110090 Castanheiras;0;0;0;0;0;0
110005 Cerejeiras;0;0;0;0;0;0
110092 Chupinguaia;150;246;417;395;579;1787
110006 Colorado do Oeste;0;0;2514;9836;3222;15572
110007 Corumbiara;0;0;0;0;672;672
110008 Costa Marques;0;0;0;0;0;0
110094 Cujubim;5529;7216;6395;5120;6495;30755
110009 Espigão D'Oeste;941;6194;69779;23130;42936;142980
110100 Governador Jorge Teixeira;0;0;0;0;0;0
110010 Guajará-Mirim;107;82;0;0;0;189
110110 Itapuã do Oeste;0;0;0;0;0;0
110011 Jaru;5005;10378;16224;11480;13462;56549
110012 Ji-Paraná;1591;1968;631;0;22998;27188
110013 Machadinho D'Oeste;575;1631;4033;31263;42409;79911
110120 Ministro Andreazza;18;32;0;0;0;50
110130 Mirante da Serra;0;0;0;0;0;0
110140 Monte Negro;0;0;0;6238;28242;34480
110014 Nova Brasilândia D'Oeste;0;0;0;0;5;5
110033 Nova Mamoré;0;0;0;3557;1162;4719
110143 Nova União;0;0;0;0;0;0
110050 Novo Horizonte do Oeste;0;0;0;0;17459;17459
110015 Ouro Preto do Oeste;0;0;0;0;0;0
110145 Parecis;0;0;0;0;0;0
110018 Pimenta Bueno;0;4054;42098;29240;34537;109929
110146 Pimenteiras do Oeste;11;0;97;838;250;1196
110020 Porto Velho;223298;187955;248825;111845;81571;853494
110025 Presidente Médici;93;130;0;0;7264;7487
110147 Primavera de Rondônia;0;0;0;0;0;0
110026 Rio Crespo;0;0;0;0;0;0
110028 Rolim de Moura;1861;2818;2650;3130;0;10459
110029 Santa Luzia D'Oeste;80;60;0;0;0;140
110148 São Felipe D'Oeste;0;0;0;0;0;0
110149 São Francisco do Guaporé;0;0;0;0;0;0
110032 São Miguel do Guaporé;234;179;0;0;2436;2849
110150 Seringueiras;0;352;812;681;722;2567
110155 Teixeirópolis;0;0;0;0;0;0
110160 Theobroma;0;308;32;0;8;348
110170 Urupá;699;1319;0;0;0;2018
110175 Vale do Anari;0;0;0;0;0;0
110180 Vale do Paraíso;0;0;0;0;0;0
110030 Vilhena;84;0;0;0;0;84
120001 Acrelândia;12;0;0;0;0;12
120005 Assis Brasil;34;0;0;0;0;34
120010 Brasiléia;231;334;0;0;0;565
120013 Bujari;0;0;0;0;0;0
120017 Capixaba;20;0;0;0;0;20
120020 Cruzeiro do Sul;516;3324;0;0;0;3840
120025 Epitaciolândia;0;0;0;0;0;0
120030 Feijó;0;0;0;0;0;0
120032 Jordão;0;0;0;0;0;0
120033 Mâncio Lima;34;0;0;0;0;34
120034 Manoel Urbano;0;0;0;0;0;0
120035 Marechal Thaumaturgo;0;0;0;0;0;0
120038 Plácido de Castro;75;0;0;0;0;75
120080 Porto Acre;4;0;0;0;0;4
120039 Porto Walter;0;0;0;0;0;0
120040 Rio Branco;38892;30409;42702;33598;48770;194371
120042 Rodrigues Alves;0;0;0;0;0;0
120043 Santa Rosa do Purus;25;0;0;0;0;25
120050 Sena Madureira;4359;105;0;0;0;4464
120045 Senador Guiomard;0;0;0;0;0;0
120060 Tarauacá;0;0;0;0;0;0
120070 Xapuri;0;0;0;0;0;0
130002 Alvarães;0;0;0;0;0;0
130006 Amaturá;0;0;0;0;0;0
130008 Anamã;0;0;0;0;0;0
130010 Anori;0;0;0;0;0;0
130014 Apuí;0;0;0;0;0;0
130020 Atalaia do Norte;0;0;0;0;0;0
130030 Autazes;0;0;0;0;0;0
130040 Barcelos;0;0;0;0;0;0
130050 Barreirinha;0;0;0;0;0;0
130060 Benjamin Constant;0;0;0;0;0;0
130063 Beruri;0;0;0;0;0;0
130068 Boa Vista do Ramos;0;0;0;0;0;0
130070 Boca do Acre;100;0;0;0;0;100
130080 Borba;0;0;0;0;0;0
130083 Caapiranga;0;0;0;0;0;0
130090 Canutama;0;0;0;0;0;0
130100 Carauari;0;0;0;0;0;0
130110 Careiro;0;0;0;0;0;0
130115 Careiro da Várzea;0;0;0;0;0;0
130120 Coari;34;0;0;0;0;34
130130 Codajás;0;0;0;0;0;0
130140 Eirunepé;218;17;0;0;0;235
130150 Envira;0;0;0;0;0;0
130160 Fonte Boa;0;0;0;0;0;0
130165 Guajará;0;0;0;0;0;0
130170 Humaitá;489;341;18992;2365;5196;27383
130180 Ipixuna;0;0;0;0;0;0
130185 Iranduba;0;0;0;0;0;0
130190 Itacoatiara;0;0;0;0;0;0
130195 Itamarati;0;0;0;0;0;0
130200 Itapiranga;0;0;0;0;0;0
130210 Japurá;0;0;0;0;0;0
130220 Juruá;0;0;0;0;0;0
130230 Jutaí;0;0;0;0;0;0
130240 Lábrea;0;0;0;0;0;0
130250 Manacapuru;0;0;0;0;0;0
130255 Manaquiri;0;0;0;0;0;0
130260 Manaus;132738;197274;349782;187040;255213;1122047
130270 Manicoré;0;0;0;0;0;0
130280 Maraã;0;0;0;0;0;0
130290 Maués;60;64;4868;24360;29317;58669
130300 Nhamundá;0;0;0;0;0;0
130310 Nova Olinda do Norte;0;0;0;0;0;0
130320 Novo Airão;0;0;35;0;0;35
130330 Novo Aripuanã;0;0;0;0;0;0
130340 Parintins;32554;36046;32527;22858;47057;171042
130350 Pauini;0;0;0;0;0;0
130353 Presidente Figueiredo;85;13;0;0;0;98
130356 Rio Preto da Eva;256;81;0;0;0;337
130360 Santa Isabel do Rio Negro;0;0;0;0;0;0
130370 Santo Antônio do Içá;0;0;0;0;0;0
130380 São Gabriel da Cachoeira;0;0;0;0;0;0
130390 São Paulo de Olivença;0;0;0;0;0;0
130395 São Sebastião do Uatumã;0;0;0;0;590;590
130400 Silves;0;0;0;0;0;0
130406 Tabatinga;0;0;0;0;0;0
130410 Tapauá;0;0;0;0;0;0
130420 Tefé;2669;3077;12810;17753;4418;40727
130423 Tonantins;0;0;0;0;0;0
130426 Uarini;0;0;0;0;0;0
130430 Urucará;84;76;0;0;23;183
130440 Urucurituba;0;0;0;0;0;0
140005 Alto Alegre;0;0;0;0;0;0
140002 Amajari;0;0;0;0;0;0
140010 Boa Vista;194973;194860;223872;155385;198408;967498
140015 Bonfim;0;0;0;0;0;0
140017 Cantá;0;0;0;0;0;0
140020 Caracaraí;0;0;0;0;0;0
140023 Caroebe;0;0;0;0;0;0
140028 Iracema;0;0;0;0;0;0
140030 Mucajaí;0;0;0;0;0;0
140040 Normandia;0;0;0;0;0;0
140045 Pacaraima;0;0;0;0;0;0
140047 Rorainópolis;1485;3647;2692;3727;1169;12720
140050 São João da Baliza;0;0;0;0;0;0
140060 São Luiz;0;0;0;0;0;0
140070 Uiramutã;0;0;0;0;0;0
150010 Abaetetuba;97590;92378;81903;46161;102858;420890
150013 Abel Figueiredo;0;0;0;0;0;0
150020 Acará;12821;0;11467;7060;30955;62303
150030 Afuá;1;0;0;0;0;1
150034 Água Azul do Norte;15592;49852;58569;67190;69278;260481
150040 Alenquer;32869;55595;55787;42098;61857;248206
150050 Almeirim;33858;63866;48277;0;41318;187319
150060 Altamira;372;0;0;0;0;372
150070 Anajás;0;0;0;0;0;0
150080 Ananindeua;8174;10490;0;0;3299;21963
150085 Anapu;1508;5833;5414;3392;1620;17767
150090 Augusto Corrêa;128;36;0;0;0;164
150095 Aurora do Pará;462;882;3658;2865;4149;12016
150100 Aveiro;0;0;0;0;0;0
150110 Bagre;0;0;0;0;0;0
150120 Baião;4170;6053;5094;4919;0;20236
150125 Bannach;0;0;1441;1069;1169;3679
150130 Barcarena;54646;49608;43324;35155;47953;230686
150140 Belém;210846;191534;297912;150306;200057;1050655
150145 Belterra;0;0;0;0;0;0
150150 Benevides;1267;1033;870;448;384;4002
150157 Bom Jesus do Tocantins;1148;458;0;375;3168;5149
150160 Bonito;13744;11971;8381;2081;0;36177
150170 Bragança;389;160;0;0;0;549
150172 Brasil Novo;189;103;0;0;0;292
150175 Brejo Grande do Araguaia;0;0;0;0;0;0
150178 Breu Branco;26833;54121;70014;39942;61393;252303
150180 Breves;2945;5459;4638;3595;6489;23126
150190 Bujaru;0;0;0;0;0;0
150200 Cachoeira do Arari;0;0;0;0;0;0
150195 Cachoeira do Piriá;46;0;0;0;0;46
150210 Cametá;73916;49769;37349;20811;44933;226778
150215 Canaã dos Carajás;45200;51224;74096;78965;100982;350467
150220 Capanema;114913;141262;144931;127052;126644;654802
150230 Capitão Poço;25423;21830;61131;65945;73356;247685
150240 Castanhal;29276;27955;85009;47825;43114;233179
150250 Chaves;0;0;0;0;0;0
150260 Colares;5538;8735;8614;4790;6076;33753
150270 Conceição do Araguaia;17916;40255;41954;19066;26399;145590
150275 Concórdia do Pará;10445;2375;0;20833;30136;63789
150276 Cumaru do Norte;7;0;0;0;0;7
150277 Curionópolis;1408;1879;1370;3452;20080;28189
150280 Curralinho;20;21;0;0;0;41
150285 Curuá;27;26;0;0;0;53
150290 Curuçá;45555;41492;25614;0;33742;146403
150293 Dom Eliseu;21576;23303;20959;2116;53301;121255
150295 Eldorado dos Carajás;11227;23217;3799;5461;4111;47815
150300 Faro;0;0;0;0;0;0
150304 Floresta do Araguaia;66;3;0;0;9075;9144
150307 Garrafão do Norte;121;1119;3251;2980;3763;11234
150309 Goianésia do Pará;13360;16086;18457;17136;10440;75479
150310 Gurupá;122337;137615;145124;69705;128195;602976
150320 Igarapé-Açu;19100;12645;18237;13084;11391;74457
150330 Igarapé-Miri;13977;13056;16841;11776;0;55650
150340 Inhangapi;34;11;0;0;0;45
150345 Ipixuna do Pará;17872;21160;28336;20407;18339;106114
150350 Irituia;0;0;3435;339;19694;23468
150360 Itaituba;52438;61963;202386;76886;117561;511234
150370 Itupiranga;211;81;0;8072;25632;33996
150375 Jacareacanga;0;0;0;0;0;0
150380 Jacundá;3677;2562;6697;9595;49752;72283
150390 Juruti;88803;151244;148288;114880;91131;594346
150400 Limoeiro do Ajuru;0;0;0;0;0;0
150405 Mãe do Rio;192;5402;18521;18757;3520;46392
150410 Magalhães Barata;0;0;0;0;0;0
150420 Marabá;136283;116601;158068;126142;188104;725198
150430 Maracanã;5299;5644;6414;3472;29067;49896
150440 Marapanim;16335;26496;12025;5451;9665;69972
150442 Marituba;3239;3768;1766;1390;1429;11592
150445 Medicilândia;6113;6755;17273;14948;45142;90231
150450 Melgaço;0;0;0;0;0;0
150460 Mocajuba;6452;7379;5052;2879;4230;25992
150470 Moju;7519;14113;25365;73238;27915;148150
150475 Mojuí dos Campos;0;0;0;0;0;0
150480 Monte Alegre;69232;131369;115718;46406;41150;403875
150490 Muaná;14925;13067;196;0;71;28259
150495 Nova Esperança do Piriá;4626;30329;28482;17862;7327;88626
150497 Nova Ipixuna;5;4;0;0;0;9
150500 Nova Timboteua;82;670;812;633;679;2876
150503 Novo Progresso;9075;15412;24430;13163;10488;72568
150506 Novo Repartimento;1860;1381;3822;8213;10122;25398
150510 Óbidos;110455;125195;141340;102352;183881;663223
150520 Oeiras do Pará;151;142;0;0;0;293
150530 Oriximiná;90667;134015;98527;12320;63757;399286
150540 Ourém;24694;27580;26518;29343;14393;122528
150543 Ourilândia do Norte;4803;2743;3756;2125;42071;55498
150548 Pacajá;3347;10989;13973;7006;74812;110127
150549 Palestina do Pará;0;0;0;0;0;0
150550 Paragominas;29601;15688;26882;13388;14994;100553
150553 Parauapebas;229657;257814;272901;191037;252788;1204197
150555 Pau D'Arco;0;0;0;0;73;73
150560 Peixe-Boi;0;0;13;0;0;13
150563 Piçarra;0;0;0;0;0;0
150565 Placas;34792;13012;73365;37044;76797;235010
150570 Ponta de Pedras;0;0;0;0;0;0
150580 Portel;23;17863;6360;4660;40;28946
150590 Porto de Moz;26712;31032;39812;27985;39708;165249
150600 Prainha;6812;5861;6807;4544;6653;30677
150610 Primavera;103;33;0;0;0;136
150611 Quatipuru;0;0;0;0;0;0
150613 Redenção;111922;92810;65481;37506;56114;363833
150616 Rio Maria;888;377;4193;15862;15246;36566
150618 Rondon do Pará;103;62;0;0;0;165
150619 Rurópolis;33003;12924;26439;13960;24203;110529
150620 Salinópolis;75076;73515;74361;60341;52046;335339
150630 Salvaterra;0;0;0;0;0;0
150635 Santa Bárbara do Pará;11;17;0;0;0;28
150640 Santa Cruz do Arari;0;0;0;0;0;0
150650 Santa Izabel do Pará;238;1583;871;573;229;3494
150655 Santa Luzia do Pará;4001;23875;14880;9722;2375;54853
150658 Santa Maria das Barreiras;1990;2106;2544;3136;18537;28313
150660 Santa Maria do Pará;6031;7275;7081;2612;3785;26784
150670 Santana do Araguaia;7346;14952;17760;25824;40633;106515
150680 Santarém;2476;3208;3063;1777;4777;15301
150690 Santarém Novo;12;0;0;0;0;12
150700 Santo Antônio do Tauá;143;0;0;0;0;143
150710 São Caetano de Odivelas;0;0;0;0;0;0
150715 São Domingos do Araguaia;1805;1649;746;838;1475;6513
150720 São Domingos do Capim;72;50;0;0;5623;5745
150730 São Félix do Xingu;8482;9980;11768;14987;11872;57089
150740 São Francisco do Pará;0;0;0;0;0;0
150745 São Geraldo do Araguaia;24302;33341;36388;21221;29201;144453
150746 São João da Ponta;0;0;0;0;0;0
150747 São João de Pirabas;57601;49054;48093;34135;39501;228384
150750 São João do Araguaia;8;13;0;0;0;21
150760 São Miguel do Guamá;7977;7198;8548;21249;21772;66744
150770 São Sebastião da Boa Vista;0;0;0;0;0;0
150775 Sapucaia;20;0;0;0;0;20
150780 Senador José Porfírio;3240;1423;0;0;0;4663
150790 Soure;5002;4756;4949;4495;4233;23435
150795 Tailândia;7698;73724;68574;28259;35771;214026
150796 Terra Alta;39;25;0;0;0;64
150797 Terra Santa;10401;25397;38721;30803;45854;151176
150800 Tomé-Açu;1092;29913;35948;27453;33677;128083
150803 Tracuateua;103;84;0;0;0;187
150805 Trairão;1511;15805;31062;22212;30096;100686
150808 Tucumã;75343;84600;78826;93516;124012;456297
150810 Tucuruí;94369;88970;111053;175251;267745;737388
150812 Ulianópolis;5733;6289;35652;41876;43276;132826
150815 Uruará;61274;101478;118137;87111;89296;457296
150820 Vigia;104097;104834;92324;43800;44085;389140
150830 Viseu;56188;58814;52296;34104;42435;243837
150835 Vitória do Xingu;0;0;0;0;0;0
150840 Xinguara;89966;38211;81175;66075;80584;356011
160010 Amapá;0;0;0;0;0;0
160020 Calçoene;0;0;0;0;0;0
160021 Cutias;0;0;0;0;0;0
160023 Ferreira Gomes;1;0;0;0;0;1
160025 Itaubal;14;0;0;0;0;14
160027 Laranjal do Jari;133;2219;4330;931;1694;9307
160030 Macapá;110725;124733;124837;11050;17576;388921
160040 Mazagão;158;91;0;0;0;249
160050 Oiapoque;18;4;0;0;0;22
160015 Pedra Branca do Amapari;0;23;0;0;0;23
160053 Porto Grande;16;0;0;0;0;16
160055 Pracuúba;0;0;0;0;0;0
160060 Santana;70;0;0;0;0;70
160005 Serra do Navio;0;0;0;0;0;0
160070 Tartarugalzinho;16;0;0;0;0;16
160080 Vitória do Jari;0;0;0;0;0;0
170025 Abreulândia;0;0;0;0;0;0
170030 Aguiarnópolis;67;6;220;124;149;566
170035 Aliança do Tocantins;27;7;0;0;1823;1857
170040 Almas;0;0;0;0;0;0
170070 Alvorada;865;511;891;855;905;4027
170100 Ananás;0;0;0;0;0;0
170105 Angico;5;0;626;0;1115;1746
170110 Aparecida do Rio Negro;0;728;3660;4590;172;9150
170130 Aragominas;31;0;0;0;0;31
170190 Araguacema;0;0;0;0;0;0
170200 Araguaçu;12;0;0;0;0;12
170210 Araguaína;429;0;0;0;0;429
170215 Araguanã;33;0;0;0;0;33
170220 Araguatins;153;220;1177;1133;1021;3704
170230 Arapoema;0;0;0;0;0;0
170240 Arraias;2924;336;0;0;0;3260
170255 Augustinópolis;5189;6739;11030;3432;16686;43076
170270 Aurora do Tocantins;0;0;0;0;0;0
170290 Axixá do Tocantins;0;0;0;0;0;0
170300 Babaçulândia;0;0;0;0;0;0
170305 Bandeirantes do Tocantins;15;0;0;0;100;115
170307 Barra do Ouro;0;0;0;0;0;0
170310 Barrolândia;977;2261;1243;732;333;5546
170320 Bernardo Sayão;0;0;0;0;0;0
170330 Bom Jesus do Tocantins;0;0;320;0;0;320
170360 Brasilândia do Tocantins;0;0;0;0;0;0
170370 Brejinho de Nazaré;0;0;722;2985;737;4444
170380 Buriti do Tocantins;1648;4404;2296;529;1028;9905
170382 Cachoeirinha;0;0;0;0;0;0
170384 Campos Lindos;0;0;0;0;0;0
170386 Cariri do Tocantins;1135;1470;2159;2350;2580;9694
170388 Carmolândia;0;0;0;0;0;0
170389 Carrasco Bonito;10;42;213;104;180;549
170390 Caseara;0;0;0;345;0;345
170410 Centenário;0;1;0;0;0;1
170510 Chapada da Natividade;0;0;0;0;180;180
170460 Chapada de Areia;7;4;0;140;0;151
170550 Colinas do Tocantins;305;0;0;0;0;305
171670 Colméia;56;0;0;0;0;56
170555 Combinado;550;1745;1824;1060;3090;8269
170560 Conceição do Tocantins;28;0;0;0;1025;1053
170600 Couto Magalhães;13;0;0;0;0;13
170610 Cristalândia;0;0;0;459;852;1311
170625 Crixás do Tocantins;0;0;0;0;0;0
170650 Darcinópolis;0;0;0;0;0;0
170700 Dianópolis;0;0;0;0;0;0
170710 Divinópolis do Tocantins;622;724;5945;14457;20743;42491
170720 Dois Irmãos do Tocantins;6;0;0;0;0;6
170730 Dueré;0;43;1565;983;0;2591
170740 Esperantina;29;28;0;0;0;57
170755 Fátima;0;0;0;0;0;0
170765 Figueirópolis;0;0;0;0;1107;1107
170770 Filadélfia;0;0;0;0;0;0
170820 Formoso do Araguaia;3418;0;1533;3814;6782;15547
170825 Fortaleza do Tabocão;0;0;0;3909;6342;10251
170830 Goianorte;259;207;227;492;495;1680
170900 Goiatins;0;384;2109;1830;2702;7025
170930 Guaraí;0;0;0;0;692;692
170950 Gurupi;0;0;35573;29861;10249;75683
170980 Ipueiras;0;0;0;0;420;420
171050 Itacajá;0;210;2312;996;81;3599
171070 Itaguatins;0;0;0;0;0;0
171090 Itapiratins;0;0;0;0;0;0
171110 Itaporã do Tocantins;14;0;0;0;0;14
171150 Jaú do Tocantins;12;0;316;355;827;1510
171180 Juarina;0;0;0;0;0;0
171190 Lagoa da Confusão;0;0;5682;4176;81;9939
171195 Lagoa do Tocantins;0;0;2901;1782;58;4741
171200 Lajeado;0;0;0;0;0;0
171215 Lavandeira;0;0;380;724;1126;2230
171240 Lizarda;0;0;0;0;0;0
171245 Luzinópolis;6;0;0;0;0;6
171250 Marianópolis do Tocantins;12;0;0;0;3203;3215
171270 Mateiros;0;0;0;0;0;0
171280 Maurilândia do Tocantins;0;0;0;0;0;0
171320 Miracema do Tocantins;60;0;0;0;0;60
171330 Miranorte;37;10;20;102;50;219
171360 Monte do Carmo;0;0;0;0;344;344
171370 Monte Santo do Tocantins;0;0;0;0;380;380
171395 Muricilândia;31;5;0;141;0;177
171420 Natividade;0;5541;12114;0;4080;21735
171430 Nazaré;14;0;245;155;0;414
171488 Nova Olinda;0;0;0;0;0;0
171500 Nova Rosalândia;137;172;199;220;883;1611
171510 Novo Acordo;0;0;0;0;0;0
171515 Novo Alegre;2535;1703;0;6589;7618;18445
171525 Novo Jardim;0;0;0;0;0;0
171550 Oliveira de Fátima;8;0;0;0;0;8
172100 Palmas;347144;361191;347533;174504;169965;1400337
171570 Palmeirante;2;0;0;0;0;2
171380 Palmeiras do Tocantins;0;0;0;0;0;0
171575 Palmeirópolis;57;0;0;0;0;57
171610 Paraíso do Tocantins;9807;11658;15002;15788;12699;64954
171620 Paranã;0;0;0;0;17782;17782
171630 Pau D'Arco;0;0;0;0;0;0
171650 Pedro Afonso;0;0;0;0;0;0
171660 Peixe;3;0;0;0;0;3
171665 Pequizeiro;63;0;0;0;8193;8256
171700 Pindorama do Tocantins;2616;0;0;0;1776;4392
171720 Piraquê;0;0;0;0;0;0
171750 Pium;0;0;0;0;1344;1344
171780 Ponte Alta do Bom Jesus;1029;706;1074;978;747;4534
171790 Ponte Alta do Tocantins;0;0;0;1566;4212;5778
171800 Porto Alegre do Tocantins;24;0;0;0;0;24
171820 Porto Nacional;121;70;0;0;2598;2789
171830 Praia Norte;15;0;3052;2855;4919;10841
171840 Presidente Kennedy;23;0;0;0;0;23
171845 Pugmil;0;0;0;0;0;0
171850 Recursolândia;11;0;0;0;0;11
171855 Riachinho;0;0;0;0;0;0
171865 Rio da Conceição;0;0;0;0;366;366
171870 Rio dos Bois;0;0;0;0;0;0
171875 Rio Sono;0;0;0;0;0;0
171880 Sampaio;0;0;324;7448;3198;10970
171884 Sandolândia;0;0;0;0;0;0
171886 Santa Fé do Araguaia;93;1825;1790;1272;3759;8739
171888 Santa Maria do Tocantins;7;0;0;0;0;7
171889 Santa Rita do Tocantins;0;0;0;0;0;0
171890 Santa Rosa do Tocantins;7;0;0;0;0;7
171900 Santa Tereza do Tocantins;0;0;0;0;0;0
172000 Santa Terezinha do Tocantins;0;0;0;0;0;0
172010 São Bento do Tocantins;0;0;0;0;0;0
172015 São Félix do Tocantins;0;0;0;0;0;0
172020 São Miguel do Tocantins;38;35;0;0;28;101
172025 São Salvador do Tocantins;0;0;0;0;0;0
172030 São Sebastião do Tocantins;2;0;0;0;0;2
172049 São Valério;14;84;2586;2742;544;5970
172065 Silvanópolis;0;72;1249;3844;0;5165
172080 Sítio Novo do Tocantins;44;0;0;0;0;44
172085 Sucupira;0;0;0;0;0;0
172090 Taguatinga;0;0;0;0;0;0
172093 Taipas do Tocantins;21;15;0;0;0;36
172097 Talismã;6;0;0;0;0;6
172110 Tocantínia;0;0;0;0;0;0
172120 Tocantinópolis;5464;7400;20530;13328;30249;76971
172125 Tupirama;0;0;0;0;0;0
172130 Tupiratins;0;0;0;0;0;0
172208 Wanderlândia;0;0;0;0;0;0
172210 Xambioá;542;641;353;381;573;2490
210005 Açailândia;38222;64007;90184;67922;101992;362327
210010 Afonso Cunha;352;360;0;0;0;712
210015 Água Doce do Maranhão;0;0;0;0;0;0
210020 Alcântara;0;0;0;4282;29147;33429
210030 Aldeias Altas;0;0;0;0;0;0
210040 Altamira do Maranhão;0;1156;2920;210;0;4286
210043 Alto Alegre do Maranhão;2452;9513;11786;7785;0;31536
210047 Alto Alegre do Pindaré;12622;74518;61492;46246;99192;294070
210050 Alto Parnaíba;0;0;0;0;0;0
210055 Amapá do Maranhão;0;0;0;0;0;0
210060 Amarante do Maranhão;19717;22884;29717;22178;16305;110801
210070 Anajatuba;35095;33988;46058;19815;7147;142103
210080 Anapurus;6176;25907;20844;9433;8333;70693
210083 Apicum-Açu;5639;20924;31153;27521;33283;118520
210087 Araguanã;225;0;0;0;0;225
210090 Araioses;9131;9633;10397;8379;8304;45844
210095 Arame;5670;33059;36477;18978;1812;95996
210100 Arari;29804;35898;36977;24697;16493;143869
210110 Axixá;4096;13021;16;108;6148;23389
210120 Bacabal;67558;97794;111003;72033;118574;466962
210125 Bacabeira;256;2934;3632;1571;6890;15283
210130 Bacuri;0;5132;6720;8288;9800;29940
210135 Bacurituba;56;0;0;0;0;56
210140 Balsas;56368;84180;114724;38971;52621;346864
210150 Barão de Grajaú;40798;28166;25214;2446;476;97100
210160 Barra do Corda;69034;93177;93689;67408;203633;526941
210170 Barreirinhas;0;0;0;0;0;0
210177 Bela Vista do Maranhão;2032;19705;19421;155016;133635;329809
210173 Belágua;0;0;5794;1688;0;7482
210180 Benedito Leite;480;1031;0;0;0;1511
210190 Bequimão;0;0;0;0;0;0
210193 Bernardo do Mearim;78;1301;5963;11823;535;19700
210197 Boa Vista do Gurupi;150;0;0;0;0;150
210200 Bom Jardim;3379;8424;4129;2839;5516;24287
210203 Bom Jesus das Selvas;3105;7817;11303;9642;7865;39732
210207 Bom Lugar;8064;5000;0;0;0;13064
210210 Brejo;2086;1098;0;0;21350;24534
210215 Brejo de Areia;72;0;150;158;33;413
210220 Buriti;2069;8821;6486;6097;0;23473
210230 Buriti Bravo;16;37;0;0;7998;8051
210232 Buriticupu;29812;91890;25322;0;0;147024
210235 Buritirana;0;0;0;0;0;0
210237 Cachoeira Grande;0;0;0;0;264;264
210240 Cajapió;2195;1402;3456;3722;3322;14097
210250 Cajari;0;0;0;0;0;0
210255 Campestre do Maranhão;2985;3710;3490;3924;3478;17587
210260 Cândido Mendes;0;0;0;0;451284;451284
210270 Cantanhede;9887;15440;27806;23955;5946;83034
210275 Capinzal do Norte;2400;2651;5800;5058;0;15909
210280 Carolina;10074;14399;3603;821;860;29757
210290 Carutapera;1;1351;195;160;564;2271
210300 Caxias;21449;16105;14030;2616;7783;61983
210310 Cedral;521;1208;320;0;960;3009
210312 Central do Maranhão;798;2018;1965;1578;0;6359
210315 Centro do Guilherme;3385;3345;0;4340;4473;15543
210317 Centro Novo do Maranhão;0;1631;4745;1128;0;7504
210320 Chapadinha;71000;52310;98238;51352;61410;334310
210325 Cidelândia;457;46;0;0;100;603
210330 Codó;53925;68939;86396;47000;41890;298150
210340 Coelho Neto;34;0;72;269;7725;8100
210350 Colinas;19564;78823;55342;47421;52361;253511
210355 Conceição do Lago-Açu;2835;20670;17944;14322;5878;61649
210360 Coroatá;46289;82613;48635;39252;35978;252767
210370 Cururupu;12;0;149;484;0;645
210375 Davinópolis;0;0;0;0;0;0
210380 Dom Pedro;9053;9939;7790;6734;0;33516
210390 Duque Bacelar;8649;11430;9587;5371;5873;40910
210400 Esperantinópolis;5479;863;4057;7728;17355;35482
210405 Estreito;38104;45249;51133;40061;45375;219922
210407 Feira Nova do Maranhão;0;0;4067;2366;4257;10690
210408 Fernando Falcão;3695;13498;22395;16178;210794;266560
210409 Formosa da Serra Negra;0;0;0;0;0;0
210410 Fortaleza dos Nogueiras;90;752;990;591;0;2423
210420 Fortuna;1519;6362;13521;3600;16639;41641
210430 Godofredo Viana;0;0;0;0;0;0
210440 Gonçalves Dias;8476;8964;7902;24800;135815;185957
210450 Governador Archer;4512;6744;3478;27000;59520;101254
210455 Governador Edison Lobão;4587;6103;4562;1735;1465;18452
210460 Governador Eugênio Barros;3070;605;259;178;1080;5192
210462 Governador Luiz Rocha;1963;936;1157;1191;187735;192982
210465 Governador Newton Bello;4097;8995;10084;8027;11229;42432
210467 Governador Nunes Freire;924;695;317;1454;552;3942
210470 Graça Aranha;0;8916;12436;9330;15904;46586
210480 Grajaú;192182;338696;363316;186136;360592;1440922
210490 Guimarães;2353;2030;1624;36;0;6043
210500 Humberto de Campos;0;0;0;0;115;115
210510 Icatu;16616;12065;6975;10895;243600;290151
210515 Igarapé do Meio;0;2320;2352;0;0;4672
210520 Igarapé Grande;22154;19992;0;0;0;42146
210530 Imperatriz;8574;5862;81507;51417;66823;214183
210535 Itaipava do Grajaú;5405;21403;25455;21116;167332;240711
210540 Itapecuru Mirim;14219;21919;85197;206234;22880;350449
210542 Itinga do Maranhão;3978;0;0;0;0;3978
210545 Jatobá;2254;4740;3212;440;11936;22582
210547 Jenipapo dos Vieiras;5235;8705;18721;7372;136180;176213
210550 João Lisboa;395;129;50;20;10;604
210560 Joselândia;2085;548;98168;199224;22136;322161
210565 Junco do Maranhão;855;766;0;0;0;1621
210570 Lago da Pedra;24294;33641;41038;31526;3312;133811
210580 Lago do Junco;968;1192;2824;2033;3439;10456
210594 Lago dos Rodrigues;11960;10640;10655;16020;16020;65295
210590 Lago Verde;43;0;1533;0;0;1576
210592 Lagoa do Mato;2929;2577;1636;954;3417;11513
210596 Lagoa Grande do Maranhão;2903;4032;2515;0;6161;15611
210598 Lajeado Novo;0;0;0;0;0;0
210600 Lima Campos;12104;4147;3732;11374;6575;37932
210610 Loreto;4727;4800;6550;3800;25389;45266
210620 Luís Domingues;0;0;0;0;0;0
210630 Magalhães de Almeida;0;604;0;0;0;604
210632 Maracaçumé;0;1662;1240;1254;3146;7302
210635 Marajá do Sena;0;0;0;0;0;0
210637 Maranhãozinho;1568;4371;5001;6106;5709;22755
210640 Mata Roma;6119;5920;20133;8828;110715;151715
210650 Matinha;4535;1567;436;275;0;6813
210660 Matões;155;649;765;974;2100;4643
210663 Matões do Norte;6495;4996;1100;371;0;12962
210667 Milagres do Maranhão;0;0;0;0;0;0
210670 Mirador;0;800;1127;171;20776;22874
210675 Miranda do Norte;12073;17506;51189;18419;7758;106945
210680 Mirinzal;1685;1904;0;0;0;3589
210690 Monção;0;0;590;651;46;1287
210700 Montes Altos;1130;0;0;0;0;1130
210710 Morros;2019;1927;2559;1687;4980;13172
210720 Nina Rodrigues;3528;3572;4835;7528;6967;26430
210725 Nova Colinas;1066;885;1784;1070;1360;6165
210730 Nova Iorque;0;6066;8496;6048;7600;28210
210735 Nova Olinda do Maranhão;294;2995;651;4648;9286;17874
210740 Olho d'Água das Cunhãs;0;0;0;2450;3613;6063
210745 Olinda Nova do Maranhão;1150;0;6985;5560;14297;27992
210750 Paço do Lumiar;0;0;35;46;21989;22070
210760 Palmeirândia;1958;3230;494;0;4975;10657
210770 Paraibano;16077;8490;14099;15219;14118;68003
210780 Parnarama;10067;16781;16171;17997;13963;74979
210790 Passagem Franca;0;0;0;1420;5215;6635
210800 Pastos Bons;0;0;20014;30326;37636;87976
210805 Paulino Neves;2176;5767;512;204;3701;12360
210810 Paulo Ramos;43;0;0;0;2704;2747
210820 Pedreiras;17487;9264;5590;11041;15291;58673
210825 Pedro do Rosário;367;0;0;0;0;367
210830 Penalva;2240;1515;318;0;600;4673
210840 Peri Mirim;452;894;0;0;0;1346
210845 Peritoró;23563;26004;38425;28739;9999;126730
210850 Pindaré-Mirim;35;0;0;0;0;35
210860 Pinheiro;0;2865;1108;1481;2616;8070
210870 Pio XII;4467;2758;0;2983;334;10542
210880 Pirapemas;10581;15783;16135;18403;21453;82355
210890 Poção de Pedras;0;484;3680;8235;0;12399
210900 Porto Franco;0;0;0;124;43987;44111
210905 Porto Rico do Maranhão;0;0;0;0;260250;260250
210910 Presidente Dutra;63658;82499;65062;15519;85607;312345
210920 Presidente Juscelino;1629;2756;0;0;9340;13725
210923 Presidente Médici;592;1260;140;700;0;2692
210927 Presidente Sarney;0;0;0;0;0;0
210930 Presidente Vargas;1482;1016;0;0;9056;11554
210940 Primeira Cruz;12933;15724;25212;78620;155866;288355
210945 Raposa;1513;2787;2618;2505;3538;12961
210950 Riachão;5584;11395;13089;12920;13311;56299
210955 Ribamar Fiquene;25;1400;1806;1829;1223;6283
210960 Rosário;13493;15272;57803;67341;18142;172051
210970 Sambaíba;2196;3850;2400;0;0;8446
210975 Santa Filomena do Maranhão;0;0;5684;11710;33048;50442
210980 Santa Helena;3057;5223;5437;0;2798;16515
210990 Santa Inês;148311;218008;214710;206373;232187;1019589
211000 Santa Luzia;37461;35945;44070;33902;152445;303823
211003 Santa Luzia do Paruá;0;0;0;0;1750;1750
211010 Santa Quitéria do Maranhão;8066;10020;20371;23925;8880;71262
211020 Santa Rita;1658;1644;2553;2308;3470;11633
211023 Santana do Maranhão;1953;2063;2815;4590;9141;20562
211027 Santo Amaro do Maranhão;2845;0;0;0;0;2845
211030 Santo Antônio dos Lopes;15085;18599;27473;25997;34251;121405
211040 São Benedito do Rio Preto;3568;15992;23486;22397;6711;72154
211050 São Bento;0;0;0;0;96018;96018
211060 São Bernardo;4620;7308;7852;9093;0;28873
211065 São Domingos do Azeitão;0;0;0;0;204;204
211070 São Domingos do Maranhão;17262;23117;41547;25860;477197;584983
211080 São Félix de Balsas;5;3766;1980;872;1455;8078
211085 São Francisco do Brejão;0;0;0;0;0;0
211090 São Francisco do Maranhão;0;0;0;0;0;0
211100 São João Batista;3992;2289;400;852;4257;11790
211102 São João do Carú;0;0;0;239;0;239
211105 São João do Paraíso;1;0;1838;0;0;1839
211107 São João do Soter;6646;14183;4854;6326;4873;36882
211110 São João dos Patos;37687;39284;39069;16456;40123;172619
211120 São José de Ribamar;15352;19770;19681;25085;21066;100954
211125 São José dos Basílios;347;1110;14526;0;377461;393444
211130 São Luís;47713;93605;83450;62553;100269;387590
211140 São Luís Gonzaga do Maranhão;3375;15370;8155;843;1587;29330
211150 São Mateus do Maranhão;24377;26679;13662;16842;39974;121534
211153 São Pedro da Água Branca;0;0;0;0;0;0
211157 São Pedro dos Crentes;0;0;37;111;149;297
211160 São Raimundo das Mangabeiras;5820;5104;5345;3434;4092;23795
211163 São Raimundo do Doca Bezerra;240;644;2297;631;4478;8290
211167 São Roberto;278;1184;0;86;2;1550
211170 São Vicente Ferrer;0;0;0;666;142987;143653
211172 Satubinha;2518;3542;1428;206;1430;9124
211174 Senador Alexandre Costa;255;2320;2286;12751;291664;309276
211176 Senador La Rocque;0;0;0;0;28;28
211178 Serrano do Maranhão;527;319;0;0;84335;85181
211180 Sítio Novo;2748;3485;5027;1765;2587;15612
211190 Sucupira do Norte;6055;5950;22068;10147;5149;49369
211195 Sucupira do Riachão;2367;3209;2443;1574;425;10018
211200 Tasso Fragoso;782;2534;2509;2204;2444;10473
211210 Timbiras;0;0;4628;2807;3157;10592
211220 Timon;76;0;0;0;0;76
211223 Trizidela do Vale;4313;4404;4166;3852;8406;25141
211227 Tufilândia;262;1983;1995;854;781;5875
211230 Tuntum;89275;341553;349273;210927;315503;1306531
211240 Turiaçu;13424;8684;14904;0;2143;39155
211245 Turilândia;1694;460;2000;0;0;4154
211250 Tutóia;2019;4497;46007;106214;10230;168967
211260 Urbano Santos;10046;16302;19281;19340;29220;94189
211270 Vargem Grande;20720;10525;8773;117429;214834;372281
211280 Viana;0;0;0;0;0;0
211285 Vila Nova dos Martírios;952;5846;5131;3917;683;16529
211290 Vitória do Mearim;0;0;4659;4770;840;10269
211300 Vitorino Freire;21613;16160;20618;22018;49250;129659
211400 Zé Doca;0;0;0;3373;30451;33824
220005 Acauã;0;0;0;0;0;0
220010 Agricolândia;0;0;0;0;0;0
220020 Água Branca;121;0;0;0;0;121
220025 Alagoinha do Piauí;43;3;0;0;0;46
220027 Alegrete do Piauí;0;0;0;0;0;0
220030 Alto Longá;37;0;0;0;0;37
220040 Altos;135;0;0;0;0;135
220045 Alvorada do Gurguéia;13;0;0;0;0;13
220050 Amarante;0;0;0;0;0;0
220060 Angical do Piauí;0;0;0;0;0;0
220070 Anísio de Abreu;0;0;0;0;0;0
220080 Antônio Almeida;0;0;0;0;0;0
220090 Aroazes;6;0;0;0;0;6
220095 Aroeiras do Itaim;0;0;0;0;0;0
220100 Arraial;0;0;0;0;0;0
220105 Assunção do Piauí;0;0;0;0;0;0
220110 Avelino Lopes;0;0;0;0;0;0
220115 Baixa Grande do Ribeiro;0;0;0;0;0;0
220117 Barra D'Alcântara;0;0;0;0;0;0
220120 Barras;22;3;0;0;0;25
220130 Barreiras do Piauí;0;0;0;0;0;0
220140 Barro Duro;0;0;0;0;0;0
220150 Batalha;71;0;0;0;0;71
220155 Bela Vista do Piauí;35;12;0;0;0;47
220157 Belém do Piauí;0;0;0;0;0;0
220160 Beneditinos;0;0;0;0;0;0
220170 Bertolínia;0;0;0;0;0;0
220173 Betânia do Piauí;39;0;0;0;0;39
220177 Boa Hora;0;0;0;0;0;0
220180 Bocaina;0;0;0;0;0;0
220190 Bom Jesus;0;0;0;0;0;0
220191 Bom Princípio do Piauí;0;0;0;0;0;0
220192 Bonfim do Piauí;0;0;0;0;0;0
220194 Boqueirão do Piauí;0;0;0;0;0;0
220196 Brasileira;0;0;0;0;0;0
220198 Brejo do Piauí;0;0;0;0;0;0
220200 Buriti dos Lopes;72;0;0;0;137904;137976
220202 Buriti dos Montes;0;0;0;0;0;0
220205 Cabeceiras do Piauí;0;0;0;0;0;0
220207 Cajazeiras do Piauí;12;0;0;0;0;12
220208 Cajueiro da Praia;0;0;0;0;0;0
220209 Caldeirão Grande do Piauí;0;0;0;0;0;0
220210 Campinas do Piauí;0;0;0;0;0;0
220211 Campo Alegre do Fidalgo;0;0;0;0;0;0
220213 Campo Grande do Piauí;0;0;0;0;0;0
220217 Campo Largo do Piauí;0;0;0;0;0;0
220220 Campo Maior;31;0;0;0;0;31
220225 Canavieira;0;0;0;0;0;0
220230 Canto do Buriti;104;68;0;0;0;172
220240 Capitão de Campos;0;0;0;0;0;0
220245 Capitão Gervásio Oliveira;0;0;0;0;0;0
220250 Caracol;0;0;0;0;0;0
220253 Caraúbas do Piauí;9;0;0;0;0;9
220255 Caridade do Piauí;7;0;0;0;0;7
220260 Castelo do Piauí;71;144;0;0;0;215
220265 Caxingó;0;0;0;0;0;0
220270 Cocal;60;24;0;0;0;84
220271 Cocal de Telha;0;0;0;0;0;0
220272 Cocal dos Alves;0;0;0;0;0;0
220273 Coivaras;0;0;0;0;0;0
220275 Colônia do Gurguéia;0;0;0;0;0;0
220277 Colônia do Piauí;0;0;0;0;0;0
220280 Conceição do Canindé;0;0;0;0;0;0
220285 Coronel José Dias;0;0;0;0;0;0
220290 Corrente;37;8;0;0;0;45
220300 Cristalândia do Piauí;0;0;0;0;0;0
220310 Cristino Castro;0;0;0;0;0;0
220320 Curimatá;0;0;0;0;0;0
220323 Currais;5;2;0;0;0;7
220327 Curral Novo do Piauí;0;0;0;0;0;0
220325 Curralinhos;0;0;0;0;0;0
220330 Demerval Lobão;0;0;0;0;0;0
220335 Dirceu Arcoverde;0;0;0;0;0;0
220340 Dom Expedito Lopes;0;0;0;0;0;0
220345 Dom Inocêncio;0;0;0;0;0;0
220342 Domingos Mourão;9;0;0;0;0;9
220350 Elesbão Veloso;0;0;0;0;0;0
220360 Eliseu Martins;0;0;0;0;0;0
220370 Esperantina;138;0;0;0;0;138
220375 Fartura do Piauí;0;0;0;0;0;0
220380 Flores do Piauí;0;0;0;0;0;0
220385 Floresta do Piauí;0;0;0;0;0;0
220390 Floriano;0;0;0;0;0;0
220400 Francinópolis;0;0;0;0;0;0
220410 Francisco Ayres;0;0;0;0;0;0
220415 Francisco Macedo;2;0;0;0;0;2
220420 Francisco Santos;0;0;0;0;0;0
220430 Fronteiras;0;0;0;0;0;0
220435 Geminiano;65;37;0;0;0;102
220440 Gilbués;0;0;0;0;0;0
220450 Guadalupe;0;0;0;0;0;0
220455 Guaribas;0;0;0;0;0;0
220460 Hugo Napoleão;0;0;0;0;0;0
220465 Ilha Grande;0;0;0;0;0;0
220470 Inhuma;104;65;0;0;0;169
220480 Ipiranga do Piauí;0;0;0;0;0;0
220490 Isaías Coelho;0;0;0;0;0;0
220500 Itainópolis;97;0;0;0;0;97
220510 Itaueira;3;0;0;0;0;3
220515 Jacobina do Piauí;0;0;0;0;0;0
220520 Jaicós;62;0;0;0;0;62
220525 Jardim do Mulato;11;0;0;0;0;11
220527 Jatobá do Piauí;0;0;0;0;0;0
220530 Jerumenha;0;0;0;0;0;0
220535 João Costa;6;0;0;0;0;6
220540 Joaquim Pires;14;0;0;0;0;14
220545 Joca Marques;0;0;0;0;0;0
220550 José de Freitas;187;0;0;0;0;187
220551 Juazeiro do Piauí;0;0;0;0;0;0
220552 Júlio Borges;0;0;0;0;0;0
220553 Jurema;0;0;0;0;0;0
220555 Lagoa Alegre;30;0;0;0;0;30
220557 Lagoa de São Francisco;0;0;0;0;0;0
220556 Lagoa do Barro do Piauí;0;0;0;0;0;0
220558 Lagoa do Piauí;1;0;0;0;0;1
220559 Lagoa do Sítio;0;0;0;0;0;0
220554 Lagoinha do Piauí;0;0;0;0;0;0
220560 Landri Sales;0;0;0;0;0;0
220570 Luís Correia;0;0;0;0;0;0
220580 Luzilândia;0;0;0;0;0;0
220585 Madeiro;0;0;0;0;0;0
220590 Manoel Emídio;0;0;0;0;0;0
220595 Marcolândia;0;0;0;0;0;0
220600 Marcos Parente;0;0;0;0;0;0
220605 Massapê do Piauí;15;20;0;0;0;35
220610 Matias Olímpio;0;0;0;0;0;0
220620 Miguel Alves;0;0;0;0;0;0
220630 Miguel Leão;0;0;0;0;0;0
220635 Milton Brandão;20;0;0;0;0;20
220640 Monsenhor Gil;0;0;0;0;0;0
220650 Monsenhor Hipólito;18;9;0;0;0;27
220660 Monte Alegre do Piauí;0;0;0;0;0;0
220665 Morro Cabeça no Tempo;0;0;0;0;0;0
220667 Morro do Chapéu do Piauí;0;0;0;0;0;0
220669 Murici dos Portelas;0;0;0;0;0;0
220670 Nazaré do Piauí;0;0;0;0;0;0
220672 Nazária;0;0;0;0;0;0
220675 Nossa Senhora de Nazaré;0;0;0;0;0;0
220680 Nossa Senhora dos Remédios;0;0;0;0;0;0
220795 Nova Santa Rita;19;0;0;0;0;19
220690 Novo Oriente do Piauí;36;0;0;0;0;36
220695 Novo Santo Antônio;2;0;0;0;0;2
220700 Oeiras;157;3;0;0;0;160
220710 Olho D'Água do Piauí;0;0;0;0;0;0
220720 Padre Marcos;0;0;0;0;0;0
220730 Paes Landim;14;0;0;0;0;14
220735 Pajeú do Piauí;12;0;0;0;0;12
220740 Palmeira do Piauí;0;0;0;0;0;0
220750 Palmeirais;0;0;0;0;0;0
220755 Paquetá;0;0;0;0;0;0
220760 Parnaguá;0;0;0;0;0;0
220770 Parnaíba;133;108;0;0;0;241
220775 Passagem Franca do Piauí;0;0;0;0;0;0
220777 Patos do Piauí;0;0;0;0;0;0
220779 Pau D'Arco do Piauí;6;0;0;0;0;6
220780 Paulistana;152;0;0;0;0;152
220785 Pavussu;0;0;0;0;0;0
220790 Pedro II;242;0;0;0;0;242
220793 Pedro Laurentino;0;0;0;0;0;0
220800 Picos;303;77;0;0;0;380
220810 Pimenteiras;13;11;0;0;0;24
220820 Pio IX;0;0;0;0;0;0
220830 Piracuruca;136;0;0;0;0;136
220840 Piripiri;55;0;0;0;0;55
220850 Porto;0;0;0;0;0;0
220855 Porto Alegre do Piauí;0;0;0;0;0;0
220860 Prata do Piauí;33;0;0;0;0;33
220865 Queimada Nova;15;0;0;0;0;15
220870 Redenção do Gurguéia;0;0;0;0;0;0
220880 Regeneração;0;0;0;0;0;0
220885 Riacho Frio;0;0;0;0;0;0
220887 Ribeira do Piauí;0;0;0;0;0;0
220890 Ribeiro Gonçalves;0;0;0;0;0;0
220900 Rio Grande do Piauí;0;0;0;0;67608;67608
220910 Santa Cruz do Piauí;0;0;0;0;0;0
220915 Santa Cruz dos Milagres;0;0;0;0;0;0
220920 Santa Filomena;67;0;0;0;0;67
220930 Santa Luz;0;0;0;0;0;0
220937 Santa Rosa do Piauí;0;0;0;0;0;0
220935 Santana do Piauí;0;0;0;0;0;0
220940 Santo Antônio de Lisboa;0;0;0;0;0;0
220945 Santo Antônio dos Milagres;0;0;0;0;0;0
220950 Santo Inácio do Piauí;0;0;0;0;0;0
220955 São Braz do Piauí;0;0;0;0;0;0
220960 São Félix do Piauí;0;0;0;0;0;0
220965 São Francisco de Assis do Piauí;0;0;0;0;0;0
220970 São Francisco do Piauí;0;0;0;0;0;0
220975 São Gonçalo do Gurguéia;0;0;0;0;0;0
220980 São Gonçalo do Piauí;0;0;0;0;0;0
220985 São João da Canabrava;0;0;0;0;0;0
220987 São João da Fronteira;40;0;0;0;0;40
220990 São João da Serra;0;0;0;0;0;0
220995 São João da Varjota;14;8;0;0;0;22
220997 São João do Arraial;0;0;0;0;0;0
221000 São João do Piauí;0;0;0;0;0;0
221005 São José do Divino;0;0;0;0;0;0
221010 São José do Peixe;0;0;0;0;0;0
221020 São José do Piauí;1;0;0;0;0;1
221030 São Julião;0;0;0;0;0;0
221035 São Lourenço do Piauí;0;0;0;0;0;0
221037 São Luis do Piauí;0;0;0;0;0;0
221038 São Miguel da Baixa Grande;0;0;0;0;0;0
221039 São Miguel do Fidalgo;0;0;0;0;0;0
221040 São Miguel do Tapuio;17;0;0;0;0;17
221050 São Pedro do Piauí;114;0;0;0;0;114
221060 São Raimundo Nonato;0;0;0;0;0;0
221062 Sebastião Barros;0;0;0;0;0;0
221063 Sebastião Leal;0;0;0;0;0;0
221065 Sigefredo Pacheco;0;0;0;0;0;0
221070 Simões;0;0;0;0;0;0
221080 Simplício Mendes;0;0;0;0;0;0
221090 Socorro do Piauí;6;0;0;0;0;6
221093 Sussuapara;0;0;0;0;0;0
221095 Tamboril do Piauí;8;0;0;0;0;8
221097 Tanque do Piauí;0;0;0;0;0;0
221100 Teresina;1234092;1477341;1382391;1237813;1279915;6611552
221110 União;64;0;0;0;0;64
221120 Uruçuí;23;0;0;0;0;23
221130 Valença do Piauí;0;0;0;0;0;0
221135 Várzea Branca;0;0;0;0;0;0
221140 Várzea Grande;0;0;0;0;0;0
221150 Vera Mendes;0;0;0;0;0;0
221160 Vila Nova do Piauí;0;0;0;0;0;0
221170 Wall Ferraz;0;0;0;0;0;0
230010 Abaiara;0;0;0;0;0;0
230015 Acarape;87;0;0;0;0;87
230020 Acaraú;804;0;0;0;455;1259
230030 Acopiara;22;0;0;0;0;22
230040 Aiuaba;0;0;0;0;0;0
230050 Alcântaras;0;0;0;0;0;0
230060 Altaneira;26;0;0;0;0;26
230070 Alto Santo;69;93;0;0;0;162
230075 Amontada;0;21;0;0;0;21
230080 Antonina do Norte;0;0;0;0;0;0
230090 Apuiarés;0;0;0;0;0;0
230100 Aquiraz;149;72;0;0;0;221
230110 Aracati;437;429;0;0;0;866
230120 Aracoiaba;0;0;0;0;0;0
230125 Ararendá;0;0;0;0;0;0
230130 Araripe;259;276;0;0;0;535
230140 Aratuba;18;0;648;2006;1360;4032
230150 Arneiroz;0;0;0;0;0;0
230160 Assaré;235;6;0;0;0;241
230170 Aurora;134;0;0;0;0;134
230180 Baixio;36;0;0;0;0;36
230185 Banabuiú;0;0;0;0;0;0
230190 Barbalha;170;0;0;0;0;170
230195 Barreira;0;0;0;0;0;0
230200 Barro;0;0;0;0;0;0
230205 Barroquinha;62;0;0;0;0;62
230210 Baturité;33;67;0;0;0;100
230220 Beberibe;248;235;0;0;0;483
230230 Bela Cruz;180;180;0;0;0;360
230240 Boa Viagem;223;49;0;0;0;272
230250 Brejo Santo;0;0;0;0;0;0
230260 Camocim;0;0;0;0;0;0
230270 Campos Sales;278;182;0;0;0;460
230280 Canindé;544;348;0;0;0;892
230290 Capistrano;0;0;0;0;0;0
230300 Caridade;44;63;0;0;0;107
230310 Cariré;57;39;0;0;0;96
230320 Caririaçu;130;0;0;0;0;130
230330 Cariús;0;0;0;0;0;0
230340 Carnaubal;239;0;0;0;0;239
230350 Cascavel;511;98;0;0;0;609
230360 Catarina;0;0;0;0;0;0
230365 Catunda;0;0;0;0;0;0
230370 Caucaia;1191;1199;0;0;0;2390
230380 Cedro;125;62;0;0;0;187
230390 Chaval;0;0;0;0;0;0
230393 Choró;19;14;0;0;0;33
230395 Chorozinho;137;178;0;0;0;315
230400 Coreaú;0;0;0;0;0;0
230410 Crateús;249;250;0;0;0;499
230420 Crato;22;0;28437;44157;36362;108978
230423 Croatá;29;24;0;0;0;53
230425 Cruz;350;202;0;0;0;552
230426 Deputado Irapuan Pinheiro;0;0;0;0;0;0
230427 Ererê;0;0;0;0;0;0
230428 Eusébio;638;517;0;0;0;1155
230430 Farias Brito;0;0;0;0;9012;9012
230435 Forquilha;83;99;0;0;0;182
230440 Fortaleza;34470;27462;25636;19768;19723;127059
230445 Fortim;71;20;0;0;0;91
230450 Frecheirinha;0;0;0;0;0;0
230460 General Sampaio;0;0;0;0;0;0
230465 Graça;0;0;0;0;0;0
230470 Granja;0;0;0;0;0;0
230480 Granjeiro;0;0;0;0;4423;4423
230490 Groaíras;51;64;0;0;0;115
230495 Guaiúba;0;0;0;0;0;0
230500 Guaraciaba do Norte;85;112;0;0;0;197
230510 Guaramiranga;4;0;0;0;0;4
230520 Hidrolândia;19;0;4977;4915;6160;16071
230523 Horizonte;612;80;0;0;0;692
230526 Ibaretama;53;34;0;0;0;87
230530 Ibiapina;243;148;0;0;0;391
230533 Ibicuitinga;0;0;0;0;0;0
230535 Icapuí;95;11;0;0;0;106
230540 Icó;286;55;0;0;0;341
230550 Iguatu;0;0;0;0;0;0
230560 Independência;83;13;0;0;0;96
230565 Ipaporanga;10;15;0;0;0;25
230570 Ipaumirim;0;0;0;0;0;0
230580 Ipu;0;0;0;0;0;0
230590 Ipueiras;147;89;0;0;0;236
230600 Iracema;62;59;0;0;0;121
230610 Irauçuba;0;0;0;0;0;0
230620 Itaiçaba;35;18;0;0;0;53
230625 Itaitinga;222;169;0;0;0;391
230630 Itapagé;45;9;0;0;0;54
230640 Itapipoca;669;0;0;0;0;669
230650 Itapiúna;0;0;0;0;0;0
230655 Itarema;120;79;2329;7262;8766;18556
230660 Itatira;0;0;0;0;0;0
230670 Jaguaretama;131;24;0;0;0;155
230680 Jaguaribara;108;103;0;0;0;211
230690 Jaguaribe;283;256;0;0;0;539
230700 Jaguaruana;99;0;0;0;0;99
230710 Jardim;57;0;0;0;0;57
230720 Jati;0;0;0;0;0;0
230725 Jijoca de Jericoacoara;0;0;0;0;0;0
230730 Juazeiro do Norte;7796;12470;29900;26310;38655;115131
230740 Jucás;0;0;0;0;0;0
230750 Lavras da Mangabeira;64;47;0;0;0;111
230760 Limoeiro do Norte;476;292;0;0;0;768
230763 Madalena;69;39;0;0;0;108
230765 Maracanaú;983;384;0;0;0;1367
230770 Maranguape;295;0;0;0;0;295
230780 Marco;125;62;0;0;0;187
230790 Martinópole;0;0;0;0;0;0
230800 Massapê;75;0;0;0;0;75
230810 Mauriti;0;0;0;0;0;0
230820 Meruoca;81;23;0;0;126;230
230830 Milagres;175;100;0;0;0;275
230835 Milhã;0;0;0;0;0;0
230837 Miraíma;79;35;0;0;0;114
230840 Missão Velha;142;0;0;0;0;142
230850 Mombaça;181;0;0;0;0;181
230860 Monsenhor Tabosa;132;100;0;0;0;232
230870 Morada Nova;77;0;0;0;0;77
230880 Moraújo;0;1;0;0;0;1
230890 Morrinhos;92;153;0;0;0;245
230900 Mucambo;0;0;0;0;0;0
230910 Mulungu;19;0;0;0;0;19
230920 Nova Olinda;0;0;0;0;0;0
230930 Nova Russas;134;34;0;0;0;168
230940 Novo Oriente;55;47;0;0;0;102
230945 Ocara;0;0;0;0;0;0
230950 Orós;100;0;0;0;0;100
230960 Pacajus;262;76;0;0;0;338
230970 Pacatuba;0;0;0;0;0;0
230980 Pacoti;52;0;0;0;0;52
230990 Pacujá;0;0;0;0;0;0
231000 Palhano;0;0;0;0;0;0
231010 Palmácia;2;0;0;0;0;2
231020 Paracuru;155;0;101;566;653;1475
231025 Paraipaba;0;0;0;0;0;0
231030 Parambu;7;63;0;0;1520;1590
231040 Paramoti;9;0;0;0;0;9
231050 Pedra Branca;30;15;0;0;0;45
231060 Penaforte;0;0;0;0;0;0
231070 Pentecoste;85;0;234;213;0;532
231080 Pereiro;189;134;0;0;0;323
231085 Pindoretama;122;191;0;0;0;313
231090 Piquet Carneiro;79;55;0;0;0;134
231095 Pires Ferreira;0;0;0;0;0;0
231100 Poranga;0;3;0;0;0;3
231110 Porteiras;191;124;0;0;0;315
231120 Potengi;0;0;0;0;0;0
231123 Potiretama;17;0;0;0;0;17
231126 Quiterianópolis;59;15;0;0;0;74
231130 Quixadá;0;8;0;0;0;8
231135 Quixelô;0;0;0;0;0;0
231140 Quixeramobim;745;475;0;343;180;1743
231150 Quixeré;0;0;0;0;0;0
231160 Redenção;134;50;0;0;0;184
231170 Reriutaba;108;52;0;0;202;362
231180 Russas;2334;5756;2641;1127;420;12278
231190 Saboeiro;0;0;0;0;0;0
231195 Salitre;123;89;0;0;0;212
231220 Santa Quitéria;0;0;0;0;0;0
231200 Santana do Acaraú;88;256;0;0;0;344
231210 Santana do Cariri;53;0;0;2990;4252;7295
231230 São Benedito;134;225;0;0;0;359
231240 São Gonçalo do Amarante;812;689;0;0;0;1501
231250 São João do Jaguaribe;0;0;0;0;0;0
231260 São Luís do Curu;0;0;0;0;0;0
231270 Senador Pompeu;227;202;0;0;0;429
231280 Senador Sá;0;21;0;0;0;21
231290 Sobral;1353;1391;0;0;0;2744
231300 Solonópole;112;86;0;0;0;198
231310 Tabuleiro do Norte;200;0;0;0;15380;15580
231320 Tamboril;103;72;1497;480;2054;4206
231325 Tarrafas;0;0;0;0;0;0
231330 Tauá;0;0;0;0;0;0
231335 Tejuçuoca;0;0;0;0;0;0
231340 Tianguá;280;122;0;0;0;402
231350 Trairi;0;0;0;0;0;0
231355 Tururu;20;0;0;0;0;20
231360 Ubajara;484;281;0;0;0;765
231370 Umari;0;0;0;0;0;0
231375 Umirim;0;0;0;0;0;0
231380 Uruburetama;105;68;0;0;0;173
231390 Uruoca;1;0;0;0;0;1
231395 Varjota;0;0;0;0;0;0
231400 Várzea Alegre;19;111;0;0;0;130
231410 Viçosa do Ceará;657;618;0;0;0;1275
240010 Acari;44;20;0;0;1021;1085
240020 Açu;443;149;0;0;0;592
240030 Afonso Bezerra;0;0;0;0;0;0
240040 Água Nova;0;0;0;0;0;0
240050 Alexandria;0;0;0;0;0;0
240060 Almino Afonso;4;0;0;0;0;4
240070 Alto do Rodrigues;83;0;0;0;0;83
240080 Angicos;77;0;0;0;0;77
240090 Antônio Martins;0;0;0;0;0;0
240100 Apodi;0;0;0;0;0;0
240110 Areia Branca;0;0;0;0;0;0
240120 Arês;0;0;0;0;0;0
240130 Augusto Severo;0;0;0;0;0;0
240140 Baía Formosa;0;0;0;0;0;0
240145 Baraúna;0;0;0;0;0;0
240150 Barcelona;0;0;0;0;0;0
240160 Bento Fernandes;0;0;0;0;0;0
240165 Bodó;0;0;0;0;0;0
240170 Bom Jesus;0;0;0;0;0;0
240180 Brejinho;65;0;0;0;0;65
240185 Caiçara do Norte;0;0;0;0;0;0
240190 Caiçara do Rio do Vento;0;0;0;0;0;0
240200 Caicó;54247;59414;67419;32695;32092;245867
240210 Campo Redondo;2;0;0;0;414;416
240220 Canguaretama;0;0;0;0;0;0
240230 Caraúbas;0;0;0;0;0;0
240240 Carnaúba dos Dantas;5;20;0;0;0;25
240250 Carnaubais;17;10;0;0;0;27
240260 Ceará-Mirim;0;0;0;0;0;0
240270 Cerro Corá;0;0;0;0;0;0
240280 Coronel Ezequiel;0;0;0;0;0;0
240290 Coronel João Pessoa;0;0;0;0;0;0
240300 Cruzeta;9;0;0;0;0;9
240310 Currais Novos;138;0;0;0;0;138
240320 Doutor Severiano;1;0;0;0;0;1
240330 Encanto;0;0;0;0;0;0
240340 Equador;7;0;0;0;0;7
240350 Espírito Santo;9;0;0;0;0;9
240360 Extremoz;0;0;0;0;0;0
240370 Felipe Guerra;0;0;0;0;0;0
240375 Fernando Pedroza;21;2;0;0;0;23
240380 Florânia;0;0;0;0;0;0
240390 Francisco Dantas;0;0;0;0;0;0
240400 Frutuoso Gomes;0;0;0;0;0;0
240410 Galinhos;0;0;0;0;0;0
240420 Goianinha;48;0;0;0;0;48
240430 Governador Dix-Sept Rosado;0;0;0;0;0;0
240440 Grossos;0;0;0;0;0;0
240450 Guamaré;0;0;0;0;0;0
240460 Ielmo Marinho;0;0;0;0;0;0
240470 Ipanguaçu;28;0;0;0;0;28
240480 Ipueira;881;1029;995;2195;4146;9246
240485 Itajá;21;11;0;0;0;32
240490 Itaú;0;0;0;0;0;0
240500 Jaçanã;4;0;0;0;0;4
240510 Jandaíra;0;0;0;0;0;0
240520 Janduís;72;69;0;0;0;141
240530 Januário Cicco;34;43;0;0;0;77
240540 Japi;31;0;0;0;0;31
240550 Jardim de Angicos;0;0;0;0;0;0
240560 Jardim de Piranhas;0;0;0;0;0;0
240570 Jardim do Seridó;6;0;0;0;0;6
240580 João Câmara;0;0;0;0;0;0
240590 João Dias;0;0;0;0;0;0
240600 José da Penha;0;0;0;0;0;0
240610 Jucurutu;89;53;0;0;593;735
240615 Jundiá;18;1;0;0;0;19
240620 Lagoa d'Anta;25;0;0;0;0;25
240630 Lagoa de Pedras;0;0;0;0;0;0
240640 Lagoa de Velhos;0;0;0;0;0;0
240650 Lagoa Nova;0;0;0;0;0;0
240660 Lagoa Salgada;0;0;0;0;0;0
240670 Lajes;0;0;0;0;0;0
240680 Lajes Pintadas;0;0;0;0;0;0
240690 Lucrécia;0;0;0;0;0;0
240700 Luís Gomes;0;0;0;0;0;0
240710 Macaíba;346;322;0;0;0;668
240720 Macau;0;0;0;0;0;0
240725 Major Sales;0;0;0;0;0;0
240730 Marcelino Vieira;0;0;0;0;0;0
240740 Martins;0;0;0;0;0;0
240750 Maxaranguape;0;0;0;0;0;0
240760 Messias Targino;0;0;0;0;0;0
240770 Montanhas;53;4;0;0;0;57
240780 Monte Alegre;101;60;0;0;0;161
240790 Monte das Gameleiras;0;0;0;0;0;0
240800 Mossoró;0;0;0;0;0;0
240810 Natal;33702;39765;39589;31850;31491;176397
240820 Nísia Floresta;0;0;0;0;0;0
240830 Nova Cruz;301;184;0;0;0;485
240840 Olho-d'Água do Borges;0;0;0;0;0;0
240850 Ouro Branco;6;0;0;0;0;6
240860 Paraná;0;0;0;0;0;0
240870 Paraú;4;6;0;0;0;10
240880 Parazinho;0;0;0;0;0;0
240890 Parelhas;110;69;0;0;0;179
240325 Parnamirim;1107;402;0;0;0;1509
240910 Passa e Fica;0;0;0;0;0;0
240920 Passagem;19;9;0;0;0;28
240930 Patu;0;0;0;0;0;0
240940 Pau dos Ferros;57;0;0;0;0;57
240950 Pedra Grande;0;0;0;0;0;0
240960 Pedra Preta;0;0;0;0;0;0
240970 Pedro Avelino;0;0;0;0;0;0
240980 Pedro Velho;21;0;0;0;0;21
240990 Pendências;35;21;0;0;0;56
241000 Pilões;0;0;0;0;0;0
241010 Poço Branco;72;0;0;0;0;72
241020 Portalegre;0;0;0;0;0;0
241025 Porto do Mangue;0;0;0;0;0;0
241040 Pureza;0;0;0;0;0;0
241050 Rafael Fernandes;0;0;0;0;0;0
241060 Rafael Godeiro;0;0;0;0;0;0
241070 Riacho da Cruz;0;0;0;0;0;0
241080 Riacho de Santana;0;0;0;0;0;0
241090 Riachuelo;0;0;0;0;0;0
240895 Rio do Fogo;0;0;0;0;0;0
241100 Rodolfo Fernandes;0;0;0;0;0;0
241110 Ruy Barbosa;0;0;0;0;0;0
241120 Santa Cruz;379;425;27938;28670;37489;94901
240933 Santa Maria;0;0;0;0;0;0
241140 Santana do Matos;0;7;0;0;0;7
241142 Santana do Seridó;0;0;0;0;0;0
241150 Santo Antônio;62;36;0;0;0;98
241160 São Bento do Norte;0;0;0;0;0;0
241170 São Bento do Trairí;0;0;0;0;0;0
241180 São Fernando;13;0;0;0;7952;7965
241190 São Francisco do Oeste;0;0;0;0;0;0
241200 São Gonçalo do Amarante;347;363;0;0;0;710
241210 São João do Sabugi;0;0;0;0;0;0
241220 São José de Mipibu;0;0;0;0;0;0
241230 São José do Campestre;0;0;0;0;0;0
241240 São José do Seridó;74;0;0;0;0;74
241250 São Miguel;0;0;0;0;0;0
241255 São Miguel do Gostoso;0;0;0;0;0;0
241260 São Paulo do Potengi;123;63;0;0;0;186
241270 São Pedro;0;3;0;0;0;3
241280 São Rafael;0;0;0;0;167;167
241290 São Tomé;0;0;0;0;0;0
241300 São Vicente;29;18;0;0;0;47
241310 Senador Elói de Souza;0;0;0;0;0;0
241320 Senador Georgino Avelino;0;0;0;0;0;0
241030 Serra Caiada;11;29;0;0;0;40
241330 Serra de São Bento;0;0;0;0;0;0
241335 Serra do Mel;0;0;0;0;0;0
241340 Serra Negra do Norte;23;0;0;0;0;23
241350 Serrinha;0;0;0;0;0;0
241355 Serrinha dos Pintos;0;0;0;0;0;0
241360 Severiano Melo;0;0;0;0;0;0
241370 Sítio Novo;1;3;0;0;0;4
241380 Taboleiro Grande;0;0;0;0;0;0
241390 Taipu;0;0;0;0;0;0
241400 Tangará;32;34;0;0;0;66
241410 Tenente Ananias;0;0;0;0;0;0
241415 Tenente Laurentino Cruz;0;0;0;0;0;0
241105 Tibau;0;0;0;0;0;0
241420 Tibau do Sul;0;0;0;0;0;0
241430 Timbaúba dos Batistas;1;5;0;0;0;6
241440 Touros;0;0;0;0;0;0
241445 Triunfo Potiguar;12;6;0;0;0;18
241450 Umarizal;0;0;0;0;0;0
241460 Upanema;0;0;0;0;0;0
241470 Várzea;2;1;0;0;0;3
241475 Venha-Ver;0;0;0;0;0;0
241480 Vera Cruz;0;0;0;0;0;0
241490 Viçosa;0;0;0;0;0;0
241500 Vila Flor;0;0;0;0;0;0
250010 Água Branca;12365;5348;0;0;0;17713
250020 Aguiar;37;4;0;0;0;41
250030 Alagoa Grande;72;0;0;0;0;72
250040 Alagoa Nova;96;91;0;0;0;187
250050 Alagoinha;34;40;0;0;0;74
250053 Alcantil;17;7;0;0;0;24
250057 Algodão de Jandaíra;14;14;0;0;0;28
250060 Alhandra;0;0;0;0;0;0
250073 Amparo;0;0;0;0;0;0
250077 Aparecida;41;17;0;0;0;58
250080 Araçagi;96;113;0;0;0;209
250090 Arara;6;0;0;0;0;6
250100 Araruna;44;63;0;0;0;107
250110 Areia;0;0;1780;3768;6654;12202
250115 Areia de Baraúnas;0;0;0;0;0;0
250120 Areial;50;79;0;0;0;129
250130 Aroeiras;12;48;0;0;0;60
250135 Assunção;0;0;0;0;0;0
250140 Baía da Traição;43;10;0;0;0;53
250150 Bananeiras;0;14;0;0;0;14
250153 Baraúna;13;3;0;0;0;16
250160 Barra de Santa Rosa;78;33;0;0;0;111
250157 Barra de Santana;31;17;0;0;0;48
250170 Barra de São Miguel;3;18;0;0;0;21
250180 Bayeux;228;0;0;0;0;228
250190 Belém;82;175;0;0;0;257
250200 Belém do Brejo do Cruz;1705;919;0;0;0;2624
250205 Bernardino Batista;0;0;0;0;0;0
250210 Boa Ventura;0;0;0;0;0;0
250215 Boa Vista;70;33;0;0;0;103
250220 Bom Jesus;7;13;0;0;0;20
250230 Bom Sucesso;0;0;0;0;0;0
250240 Bonito de Santa Fé;0;0;0;0;0;0
250250 Boqueirão;63;48;0;0;0;111
250270 Borborema;0;0;0;0;0;0
250280 Brejo do Cruz;17106;18298;0;0;2947;38351
250290 Brejo dos Santos;0;0;0;0;0;0
250300 Caaporã;96;41;0;0;0;137
250310 Cabaceiras;17;6;0;0;0;23
250320 Cabedelo;304;146;0;0;0;450
250330 Cachoeira dos Índios;0;0;3481;4811;10167;18459
250340 Cacimba de Areia;0;0;0;0;1152;1152
250350 Cacimba de Dentro;0;24;0;0;0;24
250355 Cacimbas;0;0;0;0;0;0
250360 Caiçara;0;0;0;0;0;0
250370 Cajazeiras;202;972;0;0;0;1174
250375 Cajazeirinhas;0;1448;2269;1253;979;5949
250380 Caldas Brandão;9;0;0;0;0;9
250390 Camalaú;14;7;0;0;0;21
250400 Campina Grande;3056;1757;0;0;0;4813
250403 Capim;0;0;0;0;0;0
250407 Caraúbas;23;3;0;0;0;26
250410 Carrapateira;0;0;0;0;0;0
250415 Casserengue;3;12;0;21;606;642
250420 Catingueira;0;0;0;0;0;0
250430 Catolé do Rocha;10951;22021;21607;16026;23189;93794
250435 Caturité;26;0;0;0;0;26
250440 Conceição;216;11;0;0;0;227
250450 Condado;0;0;0;0;9726;9726
250460 Conde;0;0;0;0;0;0
250470 Congo;0;0;0;0;0;0
250480 Coremas;19881;27657;37362;21543;27483;133926
250485 Coxixola;8;0;0;0;0;8
250490 Cruz do Espírito Santo;57;58;0;0;0;115
250500 Cubati;16;0;0;0;0;16
250510 Cuité;81;0;0;0;0;81
250523 Cuité de Mamanguape;10;14;0;0;0;24
250520 Cuitegi;3;4;0;0;0;7
250527 Curral de Cima;53;42;0;0;0;95
250530 Curral Velho;0;0;0;0;0;0
250535 Damião;16;0;0;0;0;16
250540 Desterro;0;0;0;0;1161;1161
250560 Diamante;14;12;0;0;0;26
250570 Dona Inês;0;0;0;0;0;0
250580 Duas Estradas;13;20;0;0;0;33
250590 Emas;0;0;0;0;0;0
250600 Esperança;242;122;0;0;0;364
250610 Fagundes;56;36;0;0;0;92
250620 Frei Martinho;6;0;0;0;0;6
250625 Gado Bravo;9;6;0;0;0;15
250630 Guarabira;465;173;1;1;0;640
250640 Gurinhém;65;0;0;0;0;65
250650 Gurjão;8;13;0;0;0;21
250660 Ibiara;36;0;0;0;0;36
250260 Igaracy;1;2;0;0;0;3
250670 Imaculada;186;0;0;0;115;301
250680 Ingá;0;0;0;0;0;0
250690 Itabaiana;64;70;0;0;0;134
250700 Itaporanga;6245;7891;9564;5564;7189;36453
250710 Itapororoca;60;0;0;0;0;60
250720 Itatuba;71;0;0;0;0;71
250730 Jacaraú;23;1;0;0;0;24
250740 Jericó;3739;3531;6927;4578;30530;49305
250750 João Pessoa;92966;65651;83248;60579;65847;368291
251365 Joca Claudino;0;0;0;0;0;0
250760 Juarez Távora;0;0;0;0;0;0
250770 Juazeirinho;41;6;0;0;0;47
250780 Junco do Seridó;2;0;0;0;0;2
250790 Juripiranga;42;0;0;0;0;42
250800 Juru;8012;7311;7702;1344;3724;28093
250810 Lagoa;38;0;0;0;0;38
250820 Lagoa de Dentro;10;27;56;48;72;213
250830 Lagoa Seca;37;18;0;0;0;55
250840 Lastro;0;0;0;0;0;0
250850 Livramento;0;0;0;0;0;0
250855 Logradouro;0;16;0;0;0;16
250860 Lucena;0;0;0;0;0;0
250870 Mãe d'Água;0;0;0;0;0;0
250880 Malta;0;0;0;0;0;0
250890 Mamanguape;353;287;0;0;0;640
250900 Manaíra;0;0;0;0;0;0
250905 Marcação;43;89;0;0;0;132
250910 Mari;70;46;0;0;0;116
250915 Marizópolis;8;0;0;0;0;8
250920 Massaranduba;35;8;0;0;0;43
250930 Mataraca;0;0;0;0;0;0
250933 Matinhas;45;34;0;0;0;79
250937 Mato Grosso;2;0;0;0;0;2
250939 Maturéia;0;0;0;0;0;0
250940 Mogeiro;0;0;0;0;0;0
250950 Montadas;4;0;0;0;0;4
250960 Monte Horebe;31;7;0;0;0;38
250970 Monteiro;97256;110371;128648;78026;106781;521082
250980 Mulungu;0;13;0;0;0;13
250990 Natuba;59;33;0;0;0;92
251000 Nazarezinho;0;0;0;0;0;0
251010 Nova Floresta;78;0;0;0;0;78
251020 Nova Olinda;0;0;0;0;0;0
251030 Nova Palmeira;4;0;0;0;0;4
251040 Olho d'Água;0;200;2028;84;0;2312
251050 Olivedos;0;0;0;0;0;0
251060 Ouro Velho;262;0;0;0;1629;1891
251065 Parari;9;4;0;0;0;13
251070 Passagem;0;0;0;0;0;0
251080 Patos;1841;3292;15570;39547;65011;125261
251090 Paulista;0;0;0;0;0;0
251100 Pedra Branca;32;10;0;0;0;42
251110 Pedra Lavrada;38;29;0;0;0;67
251120 Pedras de Fogo;0;0;0;0;0;0
251272 Pedro Régis;0;0;0;0;0;0
251130 Piancó;1470;8064;23388;23173;36232;92327
251140 Picuí;25027;32484;34651;20351;26608;139121
251150 Pilar;0;0;0;0;0;0
251160 Pilões;0;0;0;0;0;0
251170 Pilõezinhos;31;35;0;0;0;66
251180 Pirpirituba;0;0;0;0;0;0
251190 Pitimbu;0;0;0;0;0;0
251200 Pocinhos;38;3;0;0;0;41
251203 Poço Dantas;0;0;0;0;0;0
251207 Poço de José de Moura;26;6;0;0;0;32
251210 Pombal;82823;101895;107784;74186;77429;444117
251220 Prata;4;6;0;0;0;10
251230 Princesa Isabel;27222;25006;30733;15752;30763;129476
251240 Puxinanã;0;0;0;0;0;0
251250 Queimadas;184;212;0;0;0;396
251260 Quixabá;0;0;0;0;0;0
251270 Remígio;0;0;0;0;0;0
251274 Riachão;11;2;0;0;0;13
251275 Riachão do Bacamarte;0;0;0;0;0;0
251276 Riachão do Poço;0;0;0;0;0;0
251278 Riacho de Santo Antônio;0;0;0;0;0;0
251280 Riacho dos Cavalos;0;0;8615;2145;0;10760
251290 Rio Tinto;103;73;0;0;0;176
251300 Salgadinho;0;0;0;0;0;0
251310 Salgado de São Félix;0;0;0;0;0;0
251315 Santa Cecília;5;0;0;0;0;5
251320 Santa Cruz;0;0;0;0;0;0
251330 Santa Helena;0;0;0;0;0;0
251335 Santa Inês;0;0;0;0;0;0
251340 Santa Luzia;0;0;0;0;0;0
251370 Santa Rita;486;557;0;0;0;1043
251380 Santa Teresinha;0;0;0;0;234;234
251350 Santana de Mangueira;2;1;0;0;0;3
251360 Santana dos Garrotes;0;0;0;0;0;0
251385 Santo André;0;0;0;0;0;0
251392 São Bentinho;0;0;0;0;0;0
251390 São Bento;186;1586;3557;639;2880;8848
251396 São Domingos;7;0;0;0;0;7
251394 São Domingos do Cariri;7;6;0;0;0;13
251398 São Francisco;0;0;0;0;0;0
251400 São João do Cariri;38;4;0;0;0;42
250070 São João do Rio do Peixe;0;0;0;0;0;0
251410 São João do Tigre;8;4;0;0;0;12
251420 São José da Lagoa Tapada;0;0;0;0;0;0
251430 São José de Caiana;60;57;0;0;0;117
251440 São José de Espinharas;4;23;0;0;0;27
251450 São José de Piranhas;69;53;0;0;0;122
251455 São José de Princesa;0;0;0;0;0;0
251460 São José do Bonfim;0;0;0;0;0;0
251465 São José do Brejo do Cruz;5;0;0;0;0;5
251470 São José do Sabugi;39;46;0;915;1762;2762
251480 São José dos Cordeiros;15;6;0;0;0;21
251445 São José dos Ramos;0;0;0;0;0;0
251490 São Mamede;2886;8197;10494;4962;8184;34723
251500 São Miguel de Taipu;9;26;0;0;0;35
251510 São Sebastião de Lagoa de Roça;34;18;0;0;0;52
251520 São Sebastião do Umbuzeiro;0;0;0;0;0;0
251540 São Vicente do Seridó;19;30;0;0;0;49
251530 Sapé;269;109;0;0;0;378
251550 Serra Branca;60;22;0;0;0;82
251560 Serra da Raiz;2;2;0;0;0;4
251570 Serra Grande;16;0;0;0;0;16
251580 Serra Redonda;19;35;0;0;0;54
251590 Serraria;10;4;0;0;0;14
251593 Sertãozinho;0;0;0;0;0;0
251597 Sobrado;268;216;0;0;0;484
251600 Solânea;0;0;0;0;0;0
251610 Soledade;23;0;0;0;0;23
251615 Sossêgo;0;0;0;0;0;0
251620 Sousa;390;0;0;0;0;390
251630 Sumé;19533;1414;0;16082;28481;65510
251640 Tacima;2;0;0;0;0;2
251650 Taperoá;49;2;0;0;0;51
251660 Tavares;0;0;0;0;0;0
251670 Teixeira;0;0;0;0;0;0
251675 Tenório;4;0;0;0;0;4
251680 Triunfo;0;0;0;0;0;0
251690 Uiraúna;0;0;0;0;0;0
251700 Umbuzeiro;9;1;0;0;908;918
251710 Várzea;11;4;0;0;0;15
251720 Vieirópolis;9;0;0;0;0;9
250550 Vista Serrana;4;0;0;0;0;4
251740 Zabelê;0;0;0;0;0;0
260005 Abreu e Lima;0;0;0;0;0;0
260010 Afogados da Ingazeira;40897;48901;106861;110688;124910;432257
260020 Afrânio;2691;3260;3245;4067;3148;16411
260030 Agrestina;1104;1186;1695;1830;2327;8142
260040 Água Preta;0;860;1051;655;311;2877
260050 Águas Belas;0;0;0;0;0;0
260060 Alagoinha;1540;1389;4413;4437;0;11779
260070 Aliança;15250;14066;12611;8425;6271;56623
260080 Altinho;0;0;0;0;0;0
260090 Amaraji;1338;4257;2456;1600;1591;11242
260100 Angelim;22;7;0;0;0;29
260105 Araçoiaba;0;0;0;0;279;279
260110 Araripina;8000;36049;116960;44592;156341;361942
260120 Arcoverde;0;12691;12015;5708;7649;38063
260130 Barra de Guabiraba;2147;2302;2473;1572;0;8494
260140 Barreiros;12247;20367;24688;21900;20404;99606
260150 Belém de Maria;1916;2376;2178;2376;1977;10823
260160 Belém do São Francisco;0;0;0;0;0;0
260170 Belo Jardim;15921;17807;17708;14648;20061;86145
260180 Betânia;0;3118;12835;2958;10884;29795
260190 Bezerros;22643;30645;10088;13376;1468;78220
260200 Bodocó;45878;31925;38203;12625;60450;189081
260210 Bom Conselho;406;0;0;0;0;406
260220 Bom Jardim;17140;19277;10437;11555;11464;69873
260230 Bonito;16300;13463;13626;6903;6232;56524
260240 Brejão;56;1168;2535;1717;1255;6731
260250 Brejinho;13511;17562;14814;13375;20450;79712
260260 Brejo da Madre de Deus;13229;9906;1770;0;3887;28792
260270 Buenos Aires;478;1052;1152;301;439;3422
260280 Buíque;15888;14944;22185;9515;3923;66455
260290 Cabo de Santo Agostinho;0;0;0;0;0;0
260300 Cabrobó;39521;0;16610;34995;40441;131567
260310 Cachoeirinha;6641;13560;18459;11215;6033;55908
260320 Caetés;0;0;0;0;0;0
260330 Calçado;14770;1707;14455;8963;5358;45253
260340 Calumbi;2719;4722;7333;11810;15554;42138
260345 Camaragibe;0;0;0;0;0;0
260350 Camocim de São Félix;0;0;0;0;0;0
260360 Camutanga;1392;1336;1470;305;582;5085
260370 Canhotinho;20;11;0;0;164;195
260380 Capoeiras;0;0;0;0;0;0
260390 Carnaíba;25201;70244;79182;67424;85923;327974
260392 Carnaubeira da Penha;487;270;421;85;558;1821
260400 Carpina;7968;5984;7281;2845;3052;27130
260410 Caruaru;5134;6681;6054;3402;3713;24984
260415 Casinhas;4825;6542;5598;4076;4029;25070
260420 Catende;0;117;0;0;0;117
260430 Cedro;11355;14557;13825;13348;0;53085
260440 Chã de Alegria;127;154;219;711;1042;2253
260450 Chã Grande;3376;2786;11789;8496;13251;39698
260460 Condado;12643;18093;18339;14287;17516;80878
260470 Correntes;10994;4608;0;0;0;15602
260480 Cortês;2898;3099;2751;4873;5946;19567
260490 Cumaru;1885;4072;3897;2469;2632;14955
260500 Cupira;119;0;0;0;0;119
260510 Custódia;2219;5136;53851;42722;61278;165206
260515 Dormentes;80161;46406;83627;18367;42596;271157
260520 Escada;21649;21204;19937;13912;16440;93142
260530 Exu;22933;16897;25848;8322;9457;83457
260540 Feira Nova;7;0;0;0;0;7
260545 Fernando de Noronha;360;360;360;327;360;1767
260550 Ferreiros;2141;1295;1724;974;2650;8784
260560 Flores;21505;20720;19089;19651;21104;102069
260570 Floresta;0;0;0;0;0;0
260580 Frei Miguelinho;0;255;2;0;0;257
260590 Gameleira;271;89;60;238;220;878
260600 Garanhuns;0;0;0;0;0;0
260610 Glória do Goitá;1885;2473;2865;1390;2536;11149
260620 Goiana;12502;11453;11815;738;0;36508
260630 Granito;1555;1751;0;0;1304;4610
260640 Gravatá;6612;8721;9369;2876;4498;32076
260650 Iati;0;0;0;0;0;0
260660 Ibimirim;16;0;0;0;0;16
260670 Ibirajuba;2353;2906;2716;1888;963;10826
260680 Igarassu;0;0;0;0;0;0
260690 Iguaracy;24624;17825;34726;23228;31921;132324
260760 Ilha de Itamaracá;0;0;0;0;0;0
260700 Inajá;0;0;0;0;0;0
260710 Ingazeira;5471;4976;4985;2725;1281;19438
260720 Ipojuca;182;0;0;0;0;182
260730 Ipubi;6542;4512;0;0;0;11054
260740 Itacuruba;0;0;0;0;0;0
260750 Itaíba;415;0;0;0;0;415
260765 Itambé;0;0;0;0;0;0
260770 Itapetim;4436;24906;33481;16293;30165;109281
260775 Itapissuma;38;0;0;0;0;38
260780 Itaquitinga;2587;3389;3480;2816;1329;13601
260790 Jaboatão dos Guararapes;742;0;0;0;0;742
260795 Jaqueira;760;2531;2688;1344;2225;9548
260800 Jataúba;3969;4054;4083;3122;3290;18518
260805 Jatobá;513;0;0;0;0;513
260810 João Alfredo;7504;7551;6545;5986;5497;33083
260820 Joaquim Nabuco;559;615;553;84;320;2131
260825 Jucati;0;0;0;0;0;0
260830 Jupi;42;12;0;0;0;54
260840 Jurema;1753;2206;2254;2661;0;8874
260850 Lagoa de Itaenga;3913;2809;3066;1339;892;12019
260845 Lagoa do Carro;2668;3258;2829;962;1750;11467
260860 Lagoa do Ouro;0;0;0;0;0;0
260870 Lagoa dos Gatos;95;80;0;0;0;175
260875 Lagoa Grande;69;22;0;0;0;91
260880 Lajedo;0;0;0;0;0;0
260890 Limoeiro;8999;9354;5572;3988;4986;32899
260900 Macaparana;4126;3564;5110;5181;3799;21780
260910 Machados;3967;3991;2595;1440;2114;14107
260915 Manari;3082;1530;1198;1138;2323;9271
260920 Maraial;0;0;0;0;0;0
260930 Mirandiba;40318;49413;50265;15857;8866;164719
261430 Moreilândia;0;0;0;0;906;906
260940 Moreno;0;0;0;0;0;0
260950 Nazaré da Mata;10416;4898;5465;2188;2750;25717
260960 Olinda;0;0;0;0;0;0
260970 Orobó;998;248;207;58;0;1511
260980 Orocó;2053;2051;34522;21482;28214;88322
260990 Ouricuri;25411;58159;14746;1381;89649;189346
261000 Palmares;3433;3598;3481;1522;2729;14763
261010 Palmeirina;0;0;0;0;0;0
261020 Panelas;2440;1743;359;0;0;4542
261030 Paranatama;0;0;0;0;0;0
261040 Parnamirim;15725;34373;36215;12106;33010;131429
261050 Passira;4036;5344;5393;4271;1993;21037
261060 Paudalho;0;0;0;0;232;232
261070 Paulista;0;0;0;0;0;0
261080 Pedra;0;0;0;0;0;0
261090 Pesqueira;30912;35045;39463;40708;39719;185847
261100 Petrolândia;48343;55886;54824;19869;19220;198142
261110 Petrolina;466958;364479;422155;165210;302067;1720869
261120 Poção;2904;9121;9639;10265;8492;40421
261130 Pombos;5140;5094;2812;1247;1791;16084
261140 Primavera;4390;8032;9975;8397;7876;38670
261150 Quipapá;1824;3686;3670;1252;2467;12899
261153 Quixaba;5883;9155;16238;5769;12177;49222
261160 Recife;25592;23194;18379;14316;14534;96015
261170 Riacho das Almas;552;622;652;0;0;1826
261180 Ribeirão;0;0;0;0;0;0
261190 Rio Formoso;0;0;0;0;0;0
261200 Sairé;2568;3275;2848;1076;0;9767
261210 Salgadinho;397;472;314;1070;1362;3615
261220 Salgueiro;15352;13634;18232;15590;15954;78762
261230 Saloá;910;10265;3707;939;0;15821
261240 Sanharó;1268;0;0;0;4314;5582
261245 Santa Cruz;4232;6080;3155;2433;12382;28282
261247 Santa Cruz da Baixa Verde;4591;0;463;0;0;5054
261250 Santa Cruz do Capibaribe;13995;15707;17069;15405;17054;79230
261255 Santa Filomena;18086;10837;7935;6585;17325;60768
261260 Santa Maria da Boa Vista;2400;3561;0;963;26457;33381
261270 Santa Maria do Cambucá;4874;5707;5577;4488;3831;24477
261280 Santa Terezinha;4290;17253;21433;4356;723;48055
261290 São Benedito do Sul;538;1830;3176;2376;2307;10227
261300 São Bento do Una;24923;30412;25311;21150;22572;124368
261310 São Caitano;322;2323;1805;491;923;5864
261320 São João;0;0;0;0;0;0
261330 São Joaquim do Monte;17477;17439;13181;10334;7797;66228
261340 São José da Coroa Grande;3395;4474;4366;3008;3477;18720
261350 São José do Belmonte;13951;0;0;0;0;13951
261360 São José do Egito;5720;0;47134;23868;34798;111520
261370 São Lourenço da Mata;18;0;0;0;0;18
261380 São Vicente Ferrer;3931;3769;3356;2651;2851;16558
261390 Serra Talhada;50748;64042;68469;47654;42945;273858
261400 Serrita;1395;702;767;361;1535;4760
261410 Sertânia;0;12740;119502;69513;99276;301031
261420 Sirinhaém;5655;7848;12667;12901;10421;49492
261440 Solidão;792;0;0;0;0;792
261450 Surubim;20049;25490;26960;22783;27478;122760
261460 Tabira;140140;130382;115886;61585;85550;533543
261470 Tacaimbó;0;406;275;422;1556;2659
261480 Tacaratu;2689;3240;19151;31629;60162;116871
261485 Tamandaré;25322;8803;8779;7881;4076;54861
261500 Taquaritinga do Norte;6736;4395;5613;4862;4494;26100
261510 Terezinha;1214;2163;4848;1628;559;10412
261520 Terra Nova;2998;3265;3732;933;0;10928
261530 Timbaúba;3987;5764;4833;8949;5793;29326
261540 Toritama;0;0;0;0;0;0
261550 Tracunhaém;5113;4573;4377;2662;4436;21161
261560 Trindade;21154;38148;33808;5000;64781;162891
261570 Triunfo;0;3397;6694;4813;4897;19801
261580 Tupanatinga;3855;4057;3121;1574;1791;14398
261590 Tuparetama;0;19687;21432;6177;4242;51538
261600 Venturosa;36102;38236;35491;16499;10951;137279
261610 Verdejante;7126;11509;7129;4754;7340;37858
261618 Vertente do Lério;777;777;1367;1462;1307;5690
261620 Vertentes;8468;7696;8104;6698;5760;36726
261630 Vicência;2308;3450;3854;1454;2867;13933
261640 Vitória de Santo Antão;18376;13517;12265;7243;10925;62326
261650 Xexéu;45;124;146;31;1965;2311
270010 Água Branca;15419;33509;14144;8401;12800;84273
270020 Anadia;150;180;128;127;4728;5313
270030 Arapiraca;0;0;220;0;1552;1772
270040 Atalaia;17657;25397;20048;28956;24906;116964
270050 Barra de Santo Antônio;0;0;0;0;0;0
270060 Barra de São Miguel;73;0;0;0;0;73
270070 Batalha;15052;14211;11431;8431;13255;62380
270080 Belém;0;0;0;0;0;0
270090 Belo Monte;4460;6960;6960;6380;1160;25920
270100 Boca da Mata;17006;18398;20083;21591;22550;99628
270110 Branquinha;5440;2818;2248;2034;3100;15640
270120 Cacimbinhas;1332;1512;1722;1750;616;6932
270130 Cajueiro;7501;10831;15830;11005;11914;57081
270135 Campestre;2410;0;0;0;100;2510
270140 Campo Alegre;84;87;145;5464;5157;10937
270150 Campo Grande;2861;1434;1801;395;440;6931
270160 Canapi;12333;18536;25341;22855;17682;96747
270170 Capela;13909;6491;10274;5816;6314;42804
270180 Carneiros;1853;6036;7626;8284;7280;31079
270190 Chã Preta;194;6;0;0;296;496
270200 Coité do Nóia;0;0;0;0;0;0
270210 Colônia Leopoldina;2730;17890;19941;16959;18832;76352
270220 Coqueiro Seco;0;0;0;0;0;0
270230 Coruripe;6240;5784;5720;6240;3768;27752
270235 Craíbas;126;789;1462;392;613;3382
270240 Delmiro Gouveia;4552;8014;16773;3998;26879;60216
270250 Dois Riachos;4157;4090;2708;947;1047;12949
270255 Estrela de Alagoas;0;86;0;132;32;250
270260 Feira Grande;11;0;680;0;0;691
270270 Feliz Deserto;3255;3832;3616;2688;2028;15419
270280 Flexeiras;5905;4415;4095;5120;5684;25219
270290 Girau do Ponciano;1290;1132;1772;646;186;5026
270300 Ibateguara;10259;15360;17776;16069;13072;72536
270310 Igaci;0;110;0;0;0;110
270320 Igreja Nova;104;0;0;0;0;104
270330 Inhapi;19705;21334;19195;19377;19413;99024
270340 Jacaré dos Homens;0;658;799;875;2052;4384
270350 Jacuípe;736;1284;312;0;0;2332
270360 Japaratinga;1246;1070;862;475;1417;5070
270370 Jaramataia;0;0;0;0;0;0
270375 Jequiá da Praia;1508;854;810;172;3518;6862
270380 Joaquim Gomes;7390;6726;5121;9322;11856;40415
270390 Jundiá;476;0;0;0;0;476
270400 Junqueiro;99;0;0;0;0;99
270410 Lagoa da Canoa;105;10;0;0;0;115
270420 Limoeiro de Anadia;4160;1582;2076;1075;997;9890
270430 Maceió;135932;94157;68767;90743;100024;489623
270440 Major Isidoro;6249;6757;6896;7200;1674;28776
270490 Mar Vermelho;0;0;0;0;582;582
270450 Maragogi;14011;14254;11402;14847;15201;69715
270460 Maravilha;0;8708;8121;8782;7424;33035
270470 Marechal Deodoro;0;0;0;0;0;0
270480 Maribondo;3381;2628;0;0;314;6323
270500 Mata Grande;28462;31148;27762;31660;31267;150299
270510 Matriz de Camaragibe;304;695;778;702;5107;7586
270520 Messias;0;0;0;0;0;0
270530 Minador do Negrão;1332;1716;2026;1246;1164;7484
270540 Monteirópolis;268;2269;992;3066;2793;9388
270550 Murici;15611;17903;20543;20463;21816;96336
270560 Novo Lino;476;888;436;598;243;2641
270570 Olho d'Água das Flores;3200;0;8057;14741;16011;42009
270580 Olho d'Água do Casado;1283;0;338;2868;2985;7474
270590 Olho d'Água Grande;0;0;0;0;0;0
270600 Olivença;5416;4984;6148;4784;6484;27816
270610 Ouro Branco;16544;7820;8128;6958;6128;45578
270620 Palestina;0;7;0;505;336;848
270630 Palmeira dos Índios;3791;4440;5359;6162;3683;23435
270640 Pão de Açúcar;2856;2187;2023;1384;9442;17892
270642 Pariconha;13918;8247;0;0;1852;24017
270644 Paripueira;7;0;0;0;0;7
270650 Passo de Camaragibe;4196;8264;7954;8231;8241;36886
270660 Paulo Jacinto;6392;6891;7628;8033;7674;36618
270670 Penedo;35317;13806;13624;2341;25218;90306
270680 Piaçabuçu;2822;10906;5946;7599;11056;38329
270690 Pilar;30;65;0;0;0;95
270700 Pindoba;444;1341;1356;2086;1932;7159
270710 Piranhas;26704;35580;33223;33907;34196;163610
270720 Poço das Trincheiras;5688;10293;3316;0;8215;27512
270730 Porto Calvo;19907;22915;21621;22150;27317;113910
270740 Porto de Pedras;95;274;82;259;87;797
270750 Porto Real do Colégio;4166;2048;11041;12372;12539;42166
270760 Quebrangulo;5620;6103;6858;5346;3676;27603
270770 Rio Largo;175;357;0;0;0;532
270780 Roteiro;12;0;0;0;0;12
270790 Santa Luzia do Norte;0;0;0;0;0;0
270800 Santana do Ipanema;22629;29038;36376;29736;29932;147711
270810 Santana do Mundaú;6968;2020;2080;2109;1174;14351
270820 São Brás;14;0;0;0;0;14
270830 São José da Laje;5491;20318;26237;30242;26093;108381
270840 São José da Tapera;25475;26472;30315;36689;32440;151391
270850 São Luís do Quitunde;5674;8200;6891;5607;9486;35858
270860 São Miguel dos Campos;4278;2402;2155;1678;1788;12301
270870 São Miguel dos Milagres;0;0;6228;3049;2058;11335
270880 São Sebastião;0;0;0;0;0;0
270890 Satuba;0;0;0;0;0;0
270895 Senador Rui Palmeira;2532;10;882;0;1454;4878
270900 Tanque d'Arca;155;69;0;0;100;324
270910 Taquarana;0;4;0;0;104;108
270915 Teotônio Vilela;6653;14151;11835;10328;3144;46111
270920 Traipu;3790;5858;5766;4092;3882;23388
270930 União dos Palmares;8270;43755;52997;53416;55328;213766
270940 Viçosa;16419;16999;15462;18108;13693;80681
280010 Amparo de São Francisco;0;1609;1973;0;0;3582
280020 Aquidabã;6760;7818;9696;7312;6973;38559
280030 Aracaju;60506;64266;77390;40726;51259;294147
280040 Arauá;0;0;0;0;0;0
280050 Areia Branca;0;0;0;0;0;0
280060 Barra dos Coqueiros;0;0;0;0;0;0
280067 Boquim;5863;2950;4756;4270;5170;23009
280070 Brejo Grande;0;0;0;0;0;0
280100 Campo do Brito;637;813;953;1385;198;3986
280110 Canhoba;0;0;0;0;0;0
280120 Canindé de São Francisco;605;0;0;0;1776;2381
280130 Capela;0;0;0;0;0;0
280140 Carira;0;0;0;0;0;0
280150 Carmópolis;0;0;0;0;0;0
280160 Cedro de São João;0;0;62;50;0;112
280170 Cristinápolis;3824;2066;2200;2200;1242;11532
280190 Cumbe;1828;2232;2262;1734;1848;9904
280200 Divina Pastora;0;0;0;0;0;0
280210 Estância;17673;17165;21442;13635;16066;85981
280220 Feira Nova;590;484;1323;768;0;3165
280230 Frei Paulo;5633;3504;1583;2560;1000;14280
280240 Gararu;324;0;0;0;0;324
280250 General Maynard;0;0;0;0;0;0
280260 Gracho Cardoso;1372;1222;593;771;0;3958
280270 Ilha das Flores;1956;2805;3246;2131;3652;13790
280280 Indiaroba;39;36;0;0;0;75
280290 Itabaiana;4281;1824;2574;2935;3097;14711
280300 Itabaianinha;7340;6598;7708;7035;5711;34392
280310 Itabi;0;0;0;0;0;0
280320 Itaporanga d'Ajuda;0;0;0;0;0;0
280330 Japaratuba;1907;2871;1914;638;0;7330
280340 Japoatã;1953;2235;3787;3350;3031;14356
280350 Lagarto;30077;46159;37604;38589;46538;198967
280360 Laranjeiras;11;8;0;0;0;19
280370 Macambira;1904;1975;2022;1924;1446;9271
280380 Malhada dos Bois;0;0;0;0;0;0
280390 Malhador;0;0;0;0;0;0
280400 Maruim;0;0;0;0;0;0
280410 Moita Bonita;0;0;0;0;0;0
280420 Monte Alegre de Sergipe;0;0;0;0;0;0
280430 Muribeca;1064;1000;674;1187;886;4811
280440 Neópolis;0;0;0;0;0;0
280445 Nossa Senhora Aparecida;0;0;0;0;0;0
280450 Nossa Senhora da Glória;0;0;0;0;0;0
280460 Nossa Senhora das Dores;2;0;0;0;0;2
280470 Nossa Senhora de Lourdes;364;1205;1349;860;977;4755
280480 Nossa Senhora do Socorro;0;0;0;0;0;0
280490 Pacatuba;3147;3732;3452;2288;3690;16309
280500 Pedra Mole;0;0;0;0;0;0
280510 Pedrinhas;0;0;0;0;0;0
280520 Pinhão;15;17;0;0;0;32
280530 Pirambu;0;0;0;0;0;0
280540 Poço Redondo;3230;3303;4184;2060;1379;14156
280550 Poço Verde;45;0;0;0;0;45
280560 Porto da Folha;4185;4279;4400;4531;0;17395
280570 Propriá;3540;2398;3939;2450;3150;15477
280580 Riachão do Dantas;0;0;0;0;0;0
280590 Riachuelo;0;0;0;0;0;0
280600 Ribeirópolis;0;0;0;0;0;0
280610 Rosário do Catete;12;0;0;0;0;12
280620 Salgado;1884;1710;1691;2505;4350;12140
280630 Santa Luzia do Itanhy;4199;3848;3006;2470;2700;16223
280650 Santa Rosa de Lima;6;0;0;0;0;6
280640 Santana do São Francisco;1085;899;0;0;2172;4156
280660 Santo Amaro das Brotas;0;0;0;0;0;0
280670 São Cristóvão;0;0;0;0;0;0
280680 São Domingos;0;0;0;0;0;0
280690 São Francisco;138;0;0;0;0;138
280700 São Miguel do Aleixo;0;0;0;0;0;0
280710 Simão Dias;0;0;0;0;0;0
280720 Siriri;0;0;0;0;0;0
280730 Telha;0;0;0;0;0;0
280740 Tobias Barreto;37470;35729;40716;36803;48908;199626
280750 Tomar do Geru;945;666;723;4704;2232;9270
280760 Umbaúba;2896;4955;6512;5723;5600;25686
290010 Abaíra;6253;4356;3209;0;0;13818
290020 Abaré;6096;10769;13683;8916;12552;52016
290030 Acajutiba;4794;5859;5577;6816;6816;29862
290035 Adustina;159;2544;2516;1684;1983;8886
290040 Água Fria;3783;5871;5576;5976;2468;23674
290060 Aiquara;0;556;0;0;0;556
290070 Alagoinhas;2192;932;530;580;252;4486
290080 Alcobaça;7243;8149;7487;8463;8549;39891
290090 Almadina;1386;2516;1240;0;0;5142
290100 Amargosa;37677;37434;36667;40338;42824;194940
290110 Amélia Rodrigues;24;29;0;0;0;53
290115 América Dourada;6985;5541;7745;8134;6099;34504
290120 Anagé;11226;10348;11823;11793;6438;51628
290130 Andaraí;5247;5954;4960;5368;5520;27049
290135 Andorinha;4178;2997;5309;4375;5310;22169
290140 Angical;8639;5822;6211;6421;5452;32545
290150 Anguera;330;225;0;555;597;1707
290160 Antas;5150;3840;5200;2982;5111;22283
290170 Antônio Cardoso;1122;2497;2292;2078;1661;9650
290180 Antônio Gonçalves;35;37;331;1167;939;2509
290190 Aporá;8508;21578;17003;7579;1888;56556
290195 Apuarema;2259;3216;2144;1643;1343;10605
290205 Araças;1435;3613;0;0;0;5048
290200 Aracatu;5911;5855;5754;5737;5149;28406
290210 Araci;13219;15719;15487;13904;11392;69721
290220 Aramari;582;726;239;198;144;1889
290225 Arataca;4114;2643;3685;1471;263;12176
290230 Aratuípe;2280;1710;2632;3336;3380;13338
290240 Aurelino Leal;3481;4421;4661;6529;6632;25724
290250 Baianópolis;3015;2742;6225;0;1719;13701
290260 Baixa Grande;8958;9548;9342;9414;8301;45563
290265 Banzaê;3802;5583;5294;5762;4318;24759
290270 Barra;18621;24769;21359;23106;19570;107425
290280 Barra da Estiva;9357;7615;10244;8400;5822;41438
290290 Barra do Choça;8102;14775;10854;3180;2146;39057
290300 Barra do Mendes;6411;5896;5594;6097;6117;30115
290310 Barra do Rocha;1330;0;0;0;0;1330
290320 Barreiras;352876;406272;560208;247407;334156;1900919
290323 Barro Alto;5462;5120;5309;5332;5553;26776
290330 Barro Preto;511;151;1018;560;1367;3607
290327 Barrocas;4890;4301;5937;5217;5341;25686
290340 Belmonte;0;0;0;0;8620;8620
290350 Belo Campo;16653;21011;19719;9899;16725;84007
290360 Biritinga;16;2228;4219;2123;1372;9958
290370 Boa Nova;7665;6622;7826;6622;6830;35565
290380 Boa Vista do Tupim;7792;8062;8065;7842;8008;39769
290390 Bom Jesus da Lapa;223414;122232;173321;72700;147744;739411
290395 Bom Jesus da Serra;5441;4544;8317;8074;2818;29194
290400 Boninal;4742;4034;4303;4192;5866;23137
290405 Bonito;4818;3852;1091;2738;4478;16977
290410 Boquira;13069;25198;20913;20760;2084;82024
290420 Botuporã;6082;6113;6015;10280;3450;31940
290430 Brejões;3204;5360;4475;3584;2302;18925
290440 Brejolândia;3292;400;5396;5856;5240;20184
290450 Brotas de Macaúbas;5563;5368;5727;4728;3249;24635
290460 Brumado;127777;154113;123761;99428;124035;629114
290470 Buerarema;1953;1904;2889;859;1950;9555
290475 Buritirama;11046;6616;10769;8259;10381;47071
290480 Caatiba;17;31;3850;3751;3751;11400
290485 Cabaceiras do Paraguaçu;3974;1281;5222;2010;6401;18888
290490 Cachoeira;2011;0;4647;2618;4121;13397
290500 Caculé;6942;13117;14030;20857;14237;69183
290510 Caém;4414;4232;3385;4354;4299;20684
290515 Caetanos;4253;4506;4159;4203;4586;21707
290520 Caetité;54411;61007;84698;73634;77173;350923
290530 Cafarnaum;7047;5268;6948;6501;7369;33133
290540 Cairu;3714;3495;4512;1504;2960;16185
290550 Caldeirão Grande;1841;772;0;0;1878;4491
290560 Camacan;14462;13353;10095;12298;18533;68741
290570 Camaçari;557;429;0;0;0;986
290580 Camamu;9508;15226;12960;11880;12582;62156
290590 Campo Alegre de Lourdes;10885;14441;13802;13803;13564;66495
290600 Campo Formoso;32273;48506;43703;22623;51739;198844
290610 Canápolis;3513;4662;5868;3862;3380;21285
290620 Canarana;11687;9844;11111;8818;12641;54101
290630 Canavieiras;20163;24432;24432;21890;23139;114056
290640 Candeal;2691;3414;3713;4343;4298;18459
290650 Candeias;7524;9502;2253;0;10874;30153
290660 Candiba;5995;5025;2722;4282;7351;25375
290670 Cândido Sales;4534;10975;9871;6094;998;32472
290680 Cansanção;6421;27668;18364;23217;39032;114702
290682 Canudos;6925;7412;31913;34026;71347;151623
290685 Capela do Alto Alegre;0;2800;4800;2760;1874;12234
290687 Capim Grosso;40131;37434;38715;28770;36112;181162
290689 Caraíbas;2638;3404;3809;1756;1116;12723
290690 Caravelas;9937;9926;11730;5737;9396;46726
290700 Cardeal da Silva;3049;3192;2400;3677;2413;14731
290710 Carinhanha;11231;0;3858;3064;3064;21217
290720 Casa Nova;34031;28059;34941;28784;62006;187821
290730 Castro Alves;2792;7765;9471;10608;13170;43806
290740 Catolândia;50;168;24;0;0;242
290750 Catu;4298;6768;5569;2761;1945;21341
290755 Caturama;3500;3811;3175;2479;2878;15843
290760 Central;7268;6682;7335;6198;6174;33657
290770 Chorrochó;3020;4537;6438;5477;5452;24924
290780 Cícero Dantas;9680;15186;22556;10221;13751;71394
290790 Cipó;3595;0;4063;909;2474;11041
290800 Coaraci;0;752;338;0;0;1090
290810 Cocos;4430;9005;7765;5427;8636;35263
290820 Conceição da Feira;4064;7700;3300;463;1439;16966
290830 Conceição do Almeida;4456;7726;7503;4324;5640;29649
290840 Conceição do Coité;20248;13066;22389;19887;23571;99161
290850 Conceição do Jacuípe;5398;5209;5275;2865;2742;21489
290860 Conde;2443;4027;4853;5564;5215;22102
290870 Condeúba;7152;7345;10183;18299;22446;65425
290880 Contendas do Sincorá;1084;1529;1478;832;1735;6658
290890 Coração de Maria;3312;2964;3683;3257;3003;16219
290900 Cordeiros;3614;2532;2947;2931;3439;15463
290910 Coribe;1772;5349;1329;0;0;8450
290920 Coronel João Sá;3502;2589;6488;4816;2475;19870
290930 Correntina;8063;13369;20565;19620;0;61617
290940 Cotegipe;6597;5545;7054;7382;5422;32000
290950 Cravolândia;1831;1884;1727;1938;3599;10979
290960 Crisópolis;3210;3191;2645;2886;3612;15544
290970 Cristópolis;4687;6159;5997;6556;5914;29313
290980 Cruz das Almas;33905;63077;98246;66740;8513;270481
290990 Curaçá;17193;15768;1314;0;20794;55069
291000 Dário Meira;4588;1995;862;4342;1744;13531
291005 Dias d'Ávila;31243;32890;25225;18131;18543;126032
291010 Dom Basílio;2833;3436;2987;3643;5001;17900
291020 Dom Macedo Costa;1472;0;0;0;0;1472
291030 Elísio Medrado;1225;525;415;0;0;2165
291040 Encruzilhada;13443;12792;9749;0;2316;38300
291050 Entre Rios;14485;25480;30780;23085;28580;122410
290050 Érico Cardoso;4763;4848;4667;553;332;15163
291060 Esplanada;11661;12918;16192;16393;9676;66840
291070 Euclides da Cunha;27397;62137;57732;17651;15130;180047
291072 Eunápolis;73362;79733;98789;58779;87424;398087
291075 Fátima;5772;9596;8002;6871;6933;37174
291077 Feira da Mata;6924;6670;5112;3792;3792;26290
291080 Feira de Santana;107496;83310;94448;51173;68192;404619
291085 Filadélfia;11018;14505;8952;14644;22987;72106
291090 Firmino Alves;2097;3043;2931;2783;2330;13184
291100 Floresta Azul;227;0;278;0;1127;1632
291110 Formosa do Rio Preto;11904;9511;10903;6084;11482;49884
291120 Gandu;62;69;0;9425;14160;23716
291125 Gavião;1557;1903;1885;1554;1560;8459
291130 Gentio do Ouro;5233;4565;1660;3735;4980;20173
291140 Glória;5976;6235;6176;4601;4610;27598
291150 Gongogi;1495;1113;3028;2932;626;9194
291160 Governador Mangabeira;9344;8565;6931;9196;3924;37960
291165 Guajeru;316;3920;3288;3288;3288;14100
291170 Guanambi;126999;74464;95268;139622;181068;617421
291180 Guaratinga;5813;8466;8074;2897;8429;33679
291185 Heliópolis;2956;3348;752;4759;5129;16944
291190 Iaçu;595;443;250;0;0;1288
291200 Ibiassucê;6323;9745;8132;5817;5054;35071
291210 Ibicaraí;4503;4627;4251;2846;4296;20523
291220 Ibicoara;4178;6000;6000;7003;6992;30173
291230 Ibicuí;6445;4785;6058;3882;2770;23940
291240 Ibipeba;8096;7372;8559;9092;8858;41977
291250 Ibipitanga;7201;7195;7292;5768;5252;32708
291260 Ibiquera;1598;2465;1840;2760;2240;10903
291270 Ibirapitanga;9755;7655;9456;9439;9526;45831
291280 Ibirapuã;4038;4435;4245;6176;4366;23260
291290 Ibirataia;7522;5528;10032;2590;5429;31101
291300 Ibitiara;7188;8607;8626;8626;8365;41412
291310 Ibititá;14003;10222;14294;9032;10564;58115
291320 Ibotirama;34137;33754;24830;0;0;92721
291330 Ichu;2440;2833;2387;2825;2144;12629
291340 Igaporã;5150;8348;8839;5248;4602;32187
291345 Igrapiúna;4448;5455;4834;3615;5250;23602
291350 Iguaí;2965;2342;13644;11496;11081;41528
291360 Ilhéus;4225;4764;6473;1887;3221;20570
291370 Inhambupe;9780;4979;4979;5225;9943;34906
291380 Ipecaetá;5734;5802;5763;7811;6053;31163
291390 Ipiaú;10417;13988;18787;16135;14152;73479
291400 Ipirá;9641;6750;28336;18187;10191;73105
291410 Ipupiara;5066;4672;4392;4401;4516;23047
291420 Irajuba;2280;2090;2090;2090;2520;11070
291430 Iramaia;9094;8436;8436;8436;8599;43001
291440 Iraquara;13797;12000;12164;10726;14697;63384
291450 Irará;19163;49651;34018;21621;12881;137334
291460 Irecê;197159;66077;216427;106601;145778;732042
291465 Itabela;14501;16118;23295;16695;24980;95589
291470 Itaberaba;19768;75664;70934;73176;76182;315724
291480 Itabuna;14471;12786;23712;6596;5463;63028
291490 Itacaré;436;386;490;716;1007;3035
291500 Itaeté;6539;6918;6855;6232;5151;31695
291510 Itagi;1067;3984;4185;3770;4026;17032
291520 Itagibá;0;5944;6744;8400;6178;27266
291530 Itagimirim;0;0;0;0;0;0
291535 Itaguaçu da Bahia;6424;5888;5482;0;5550;23344
291540 Itaju do Colônia;4165;3163;3185;3526;3388;17427
291550 Itajuípe;2402;3451;2968;3003;2840;14664
291560 Itamaraju;29888;19073;30895;27459;31278;138593
291570 Itamari;2393;3626;4051;3553;2324;15947
291580 Itambé;10973;12081;14089;12174;14755;64072
291590 Itanagra;2;25;0;0;0;27
291600 Itanhém;5860;8650;2682;10634;1737;29563
291610 Itaparica;1016;8131;22665;11933;0;43745
291620 Itapé;1890;1199;1042;241;461;4833
291630 Itapebi;3426;2753;0;0;830;7009
291640 Itapetinga;18249;18463;18017;14653;15116;84498
291650 Itapicuru;11155;2900;4177;3553;4442;26227
291660 Itapitanga;0;1981;3786;3448;524;9739
291670 Itaquara;3138;3179;2787;2497;3146;14747
291680 Itarantim;5349;7657;8212;7886;7897;37001
291685 Itatim;13019;20884;19533;12342;14288;80066
291690 Itiruçu;4540;6938;6936;6271;5780;30465
291700 Itiúba;21408;28176;30496;26688;45713;152481
291710 Itororó;7224;7211;6967;5110;6783;33295
291720 Ituaçu;963;98;1953;4910;369;8293
291730 Ituberá;9150;9604;9877;9538;9566;47735
291733 Iuiú;6274;5988;6321;6090;4839;29512
291735 Jaborandi;4012;6035;5880;5880;5880;27687
291740 Jacaraci;7083;5649;6237;6804;6808;32581
291750 Jacobina;2046;4453;10836;7791;10522;35648
291760 Jaguaquara;18651;15898;15762;13196;15988;79495
291770 Jaguarari;17304;18884;21786;27500;28271;113745
291780 Jaguaripe;7027;6627;6211;6287;6300;32452
291790 Jandaíra;1917;1029;4561;3883;4589;15979
291800 Jequié;250;100;0;0;0;350
291810 Jeremoabo;13369;6306;4541;3720;11420;39356
291820 Jiquiriçá;6734;6589;6736;8400;7656;36115
291830 Jitaúna;6815;2656;7333;6441;6732;29977
291835 João Dourado;12219;9328;12383;7841;8981;50752
291840 Juazeiro;110854;128973;143918;111558;137927;633230
291845 Jucuruçu;1076;1835;1572;1179;1550;7212
291850 Jussara;7826;7577;5677;5482;7541;34103
291855 Jussari;1386;2301;2340;3146;2898;12071
291860 Jussiape;49;34;2913;3888;3807;10691
291870 Lafaiete Coutinho;408;726;742;0;0;1876
291875 Lagoa Real;6858;5771;4826;4470;5933;27858
291880 Laje;194;619;637;536;759;2745
291890 Lajedão;2520;2196;1726;2132;3883;12457
291900 Lajedinho;0;0;0;0;0;0
291905 Lajedo do Tabocal;4236;3981;5388;2694;4325;20624
291910 Lamarão;2266;346;0;1368;1004;4984
291915 Lapão;11956;9716;11344;10190;12235;55441
291920 Lauro de Freitas;62;0;0;0;0;62
291930 Lençóis;2838;5395;6578;3203;0;18014
291940 Licínio de Almeida;8103;6684;6648;6613;7145;35193
291950 Livramento de Nossa Senhora;52289;66941;81092;48496;51421;300239
291955 Luís Eduardo Magalhães;85086;126021;125531;63318;82940;482896
291960 Macajuba;4838;5063;4885;5028;5174;24988
291970 Macarani;6565;6652;6648;6597;5970;32432
291980 Macaúbas;38574;49156;47557;29984;27778;193049
291990 Macururé;2575;2630;1259;1232;2860;10556
291992 Madre de Deus;60;947;6367;3744;4122;15240
291995 Maetinga;0;0;227;691;4008;4926
292000 Maiquinique;0;205;3135;3357;2905;9602
292010 Mairi;8512;8563;8524;8559;8628;42786
292020 Malhada;7995;7715;7775;7038;6206;36729
292030 Malhada de Pedras;1435;768;2136;2154;2865;9358
292040 Manoel Vitorino;1851;5554;4158;5082;5082;21727
292045 Mansidão;3557;3205;5579;3924;7274;23539
292050 Maracás;15552;18076;16972;3145;0;53745
292060 Maragogipe;16705;13588;16610;15012;5665;67580
292070 Maraú;5873;6209;6071;4182;6205;28540
292080 Marcionílio Souza;2883;3015;3253;3243;5131;17525
292090 Mascote;0;4139;6412;7208;5027;22786
292100 Mata de São João;94;30;0;0;0;124
292105 Matina;6803;6792;6557;5024;8702;33878
292110 Medeiros Neto;15726;14966;12720;12371;10302;66085
292120 Miguel Calmon;7421;8325;7823;3691;7681;34941
292130 Milagres;3526;2621;3931;5412;5488;20978
292140 Mirangaba;3200;6720;16272;16493;2590;45275
292145 Mirante;703;505;224;356;276;2064
292150 Monte Santo;9573;0;602;2120;4425;16720
292160 Morpará;1230;5417;2694;1464;5050;15855
292170 Morro do Chapéu;91264;132471;38859;19988;78031;360613
292180 Mortugaba;6933;6551;6538;6355;5870;32247
292190 Mucugê;6374;9588;8479;9732;9292;43465
292200 Mucuri;15541;17390;18887;11290;10732;73840
292205 Mulungu do Morro;6053;5409;6047;7196;4913;29618
292210 Mundo Novo;10822;10418;7762;5561;14189;48752
292220 Muniz Ferreira;784;1764;2496;1375;1700;8119
292225 Muquém de São Francisco;3017;5088;1272;2764;3101;15242
292230 Muritiba;9729;23318;16800;23498;17795;91140
292240 Mutuípe;4575;8866;8856;9109;8795;40201
292250 Nazaré;6975;10447;10454;8793;10435;47104
292260 Nilo Peçanha;5999;6108;5615;5690;4953;28365
292265 Nordestina;503;5115;6500;8276;12246;32640
292270 Nova Canaã;3859;3480;4825;2902;7671;22737
292273 Nova Fátima;3103;2073;2850;3136;3192;14354
292275 Nova Ibiá;3212;3210;3204;2664;3273;15563
292280 Nova Itarana;772;3301;3468;3462;3616;14619
292285 Nova Redenção;2176;2330;2785;1969;2200;11460
292290 Nova Soure;8487;2713;19015;13712;10159;54086
292300 Nova Viçosa;18224;3809;773;11930;18285;53021
292303 Novo Horizonte;3917;5309;3325;4533;4770;21854
292305 Novo Triunfo;1973;4195;5563;5181;6027;22939
292310 Olindina;3424;1290;7576;1693;11342;25325
292320 Oliveira dos Brejinhos;10367;9115;9912;6233;15182;50809
292330 Ouriçangas;2961;2230;1726;273;1777;8967
292335 Ourolândia;52;0;0;3898;2198;6148
292340 Palmas de Monte Alto;8107;9403;9894;8809;8982;45195
292350 Palmeiras;4425;4368;3945;4176;4298;21212
292360 Paramirim;7054;33818;31104;14688;20000;106664
292370 Paratinga;7525;14286;14498;14815;14110;65234
292380 Paripiranga;5259;12731;13103;11268;8737;51098
292390 Pau Brasil;4792;5495;4633;3990;3687;22597
292400 Paulo Afonso;172974;264552;255039;112655;158570;963790
292405 Pé de Serra;4581;5553;6642;6223;4940;27939
292410 Pedrão;2784;2544;2477;2544;2544;12893
292420 Pedro Alexandre;2096;4186;3136;473;4418;14309
292430 Piatã;5508;9180;8075;9240;8168;40171
292440 Pilão Arcado;10122;10888;9488;3542;388;34428
292450 Pindaí;3431;4149;8864;0;3512;19956
292460 Pindobaçu;17527;17367;11232;354;42954;89434
292465 Pintadas;4598;4622;4526;4548;4158;22452
292467 Piraí do Norte;3625;3221;4150;4030;3645;18671
292470 Piripá;4723;5831;4366;5348;4789;25057
292480 Piritiba;9269;9958;10449;9161;9176;48013
292490 Planaltino;3149;2641;3783;3160;3997;16730
292500 Planalto;8713;8426;8578;6960;16523;49200
292510 Poções;18414;17772;17767;16086;16822;86861
292520 Pojuca;38923;9305;24718;15291;17856;106093
292525 Ponto Novo;4206;2597;3036;27000;38678;75517
292530 Porto Seguro;55233;11116;20902;20000;25424;132675
292540 Potiraguá;4690;4700;4756;4758;4717;23621
292550 Prado;0;0;700;100;1894;2694
292560 Presidente Dutra;5351;6000;6062;5931;6280;29624
292570 Presidente Jânio Quadros;4060;3889;4994;3141;4497;20581
292575 Presidente Tancredo Neves;12532;11186;10547;11022;11130;56417
292580 Queimadas;9661;9330;10623;11697;11733;53044
292590 Quijingue;9773;21282;23109;15579;18912;88655
292593 Quixabeira;3636;3375;2530;1450;2573;13564
292595 Rafael Jambeiro;6431;9603;9576;9576;6024;41210
292600 Remanso;20530;24234;15689;41498;73733;175684
292610 Retirolândia;4754;6634;3610;2551;2047;19596
292620 Riachão das Neves;11070;10100;8900;6080;11740;47890
292630 Riachão do Jacuípe;13866;12636;13619;14094;13625;67840
292640 Riacho de Santana;16438;14219;15332;14165;11509;71663
292650 Ribeira do Amparo;6926;7424;6958;6981;7448;35737
292660 Ribeira do Pombal;14505;15545;12690;19683;19574;81997
292665 Ribeirão do Largo;5691;5585;3553;5924;6127;26880
292670 Rio de Contas;4706;88;0;10560;8822;24176
292680 Rio do Antônio;5844;5378;4813;4871;7058;27964
292690 Rio do Pires;5522;6300;6480;7008;7068;32378
292700 Rio Real;26160;7240;8298;12323;12450;66471
292710 Rodelas;4323;3311;3422;2766;3419;17241
292720 Ruy Barbosa;13838;12233;13177;13252;3350;55850
292730 Salinas da Margarida;3333;6009;6032;5957;5020;26351
292740 Salvador;70015;96772;67280;33066;48612;315745
292750 Santa Bárbara;179;252;0;0;0;431
292760 Santa Brígida;0;0;4215;12358;7845;24418
292770 Santa Cruz Cabrália;14748;13804;15820;15218;15503;75093
292780 Santa Cruz da Vitória;2634;2638;2112;3223;1713;12320
292790 Santa Inês;2356;4372;4489;4125;4473;19815
292805 Santa Luzia;4453;5220;6589;4924;5284;26470
292810 Santa Maria da Vitória;25102;18650;29560;12600;32790;118702
292840 Santa Rita de Cássia;6874;14265;12550;9392;1784;44865
292850 Santa Teresinha;2820;925;972;1278;5381;11376
292800 Santaluz;109923;112548;116645;85017;69859;493992
292820 Santana;13645;13351;12981;10147;11543;61667
292830 Santanópolis;436;1571;1419;1548;1548;6522
292860 Santo Amaro;13327;93;10549;15253;0;39222
292870 Santo Antônio de Jesus;30753;42483;41998;40421;43792;199447
292880 Santo Estêvão;2685;6445;5966;2129;0;17225
292890 São Desidério;20393;68297;56801;34124;42651;222266
292895 São Domingos;1879;4064;3774;0;4178;13895
292910 São Felipe;1546;2741;9251;2078;6545;22161
292900 São Félix;14399;13614;29309;19783;26902;104007
292905 São Félix do Coribe;7940;27180;41757;11984;16322;105183
292920 São Francisco do Conde;8;2;0;0;0;10
292925 São Gabriel;9194;9319;9285;9474;7293;44565
292930 São Gonçalo dos Campos;4208;4464;4309;2471;935;16387
292935 São José da Vitória;383;212;0;761;840;2196
292937 São José do Jacuípe;31;0;0;0;0;31
292940 São Miguel das Matas;265;1109;4532;4333;2799;13038
292950 São Sebastião do Passé;11510;13689;11341;16441;15651;68632
292960 Sapeaçu;10196;8500;9646;7870;9375;45587
292970 Sátiro Dias;700;1103;1267;530;3000;6600
292975 Saubara;2160;2739;4692;4694;4691;18976
292980 Saúde;3722;4960;4890;4024;0;17596
292990 Seabra;19089;19627;11407;19659;22077;91859
293000 Sebastião Laranjeiras;5402;5664;5684;5936;3684;26370
293010 Senhor do Bonfim;56700;35502;43326;13263;7985;156776
293020 Sento Sé;17708;20784;19563;15718;13896;87669
293015 Serra do Ramalho;9511;13618;14985;2417;11404;51935
293030 Serra Dourada;4372;3718;5734;3120;2968;19912
293040 Serra Preta;2400;2388;2258;2388;1967;11401
293050 Serrinha;5357;29966;27865;11559;7475;82222
293060 Serrolândia;5171;5099;4450;2635;4904;22259
293070 Simões Filho;242;0;0;0;0;242
293075 Sítio do Mato;1474;4940;4642;1219;504;12779
293076 Sítio do Quinto;4928;7224;5754;3469;2211;23586
293077 Sobradinho;1657;6427;32259;20253;20492;81088
293080 Souto Soares;10774;10359;9448;9211;11346;51138
293090 Tabocas do Brejo Velho;5758;6340;6178;6501;3835;28612
293100 Tanhaçu;10746;10644;9152;6994;9939;47475
293105 Tanque Novo;8831;8414;8613;7035;19739;52632
293110 Tanquinho;3132;2947;2926;3122;3345;15472
293120 Taperoá;8319;7433;8062;4101;7175;35090
293130 Tapiramutá;7401;6521;6293;6833;4721;31769
293135 Teixeira de Freitas;27138;33483;31354;15952;24075;132002
293140 Teodoro Sampaio;17;2;0;226;2055;2300
293150 Teofilândia;3277;2224;3494;6448;7989;23432
293160 Teolândia;6566;5401;9366;7519;11874;40726
293170 Terra Nova;4426;4999;5248;5066;5376;25115
293180 Tremedal;7709;7926;7786;3606;10064;37091
293190 Tucano;14040;34922;40954;35847;15531;141294
293200 Uauá;9721;7132;21301;4284;2777;45215
293210 Ubaíra;10468;10525;9916;9690;10063;50662
293220 Ubaitaba;5821;7457;4816;8443;7102;33639
293230 Ubatã;11276;10078;10679;10616;8609;51258
293240 Uibaí;3550;4953;3236;6102;6204;24045
293245 Umburanas;638;0;0;0;641;1279
293250 Una;11812;11079;11076;11151;11872;56990
293260 Urandi;7748;8294;9048;9048;9048;43186
293270 Uruçuca;1940;3400;2011;4116;4040;15507
293280 Utinga;7246;6290;5961;2547;0;22044
293290 Valença;18344;28339;38922;35695;39351;160651
293300 Valente;8130;7188;8901;5026;7656;36901
293305 Várzea da Roça;1970;490;0;0;0;2460
293310 Várzea do Poço;2960;3409;1511;1536;1486;10902
293315 Várzea Nova;65;0;0;0;0;65
293317 Varzedo;0;0;0;0;0;0
293320 Vera Cruz;154;45;0;0;0;199
293325 Vereda;2017;2836;4761;7866;5969;23449
293330 Vitória da Conquista;101078;100558;84403;34471;57230;377740
293340 Wagner;0;0;0;0;0;0
293345 Wanderley;5666;5665;5716;5824;2373;25244
293350 Wenceslau Guimarães;8809;9305;10114;13707;14300;56235
293360 Xique-Xique;26469;29104;34036;31257;38243;159109
310010 Abadia dos Dourados;0;0;0;0;0;0
310020 Abaeté;141;121;124;110;0;496
310030 Abre Campo;0;0;0;0;0;0
310040 Acaiaca;0;0;0;0;0;0
310050 Açucena;0;0;0;0;0;0
310060 Água Boa;24;0;0;0;0;24
310070 Água Comprida;0;0;0;0;0;0
310080 Aguanil;0;0;0;0;0;0
310090 Águas Formosas;1689;11503;3634;0;0;16826
310100 Águas Vermelhas;24;0;0;0;0;24
310110 Aimorés;11362;13144;10819;14855;12376;62556
310120 Aiuruoca;0;0;0;0;0;0
310130 Alagoa;0;0;0;0;0;0
310140 Albertina;0;0;0;0;0;0
310150 Além Paraíba;93;0;0;0;0;93
310160 Alfenas;29022;26316;17085;23879;30752;127054
310163 Alfredo Vasconcelos;0;0;0;0;0;0
310170 Almenara;135028;34300;0;0;0;169328
310180 Alpercata;27;0;0;0;0;27
310190 Alpinópolis;0;0;0;0;0;0
310200 Alterosa;0;0;0;0;0;0
310205 Alto Caparaó;0;0;0;0;0;0
315350 Alto Jequitibá;0;0;0;0;0;0
310210 Alto Rio Doce;0;1;0;0;0;1
310220 Alvarenga;0;0;0;0;0;0
310230 Alvinópolis;0;0;0;0;0;0
310240 Alvorada de Minas;0;0;0;0;0;0
310250 Amparo do Serra;6;0;0;0;0;6
310260 Andradas;0;0;0;0;0;0
310280 Andrelândia;14;0;0;0;0;14
310285 Angelândia;51;18;0;0;0;69
310290 Antônio Carlos;7390;1063;0;0;1210;9663
310300 Antônio Dias;26;3;0;0;0;29
310310 Antônio Prado de Minas;0;0;0;0;0;0
310320 Araçaí;0;0;0;0;0;0
310330 Aracitaba;0;0;0;0;0;0
310340 Araçuaí;47631;27721;0;11284;0;86636
310350 Araguari;0;0;0;0;0;0
310360 Arantina;4;0;0;0;0;4
310370 Araponga;0;0;0;0;0;0
310375 Araporã;62;35;0;0;0;97
310380 Arapuá;0;0;0;0;0;0
310390 Araújos;44;69;0;0;0;113
310400 Araxá;0;0;0;0;0;0
310410 Arceburgo;0;0;0;0;0;0
310420 Arcos;165;144;0;0;0;309
310430 Areado;0;0;0;0;0;0
310440 Argirita;9;9;0;0;0;18
310445 Aricanduva;0;0;0;0;0;0
310450 Arinos;0;0;0;0;0;0
310460 Astolfo Dutra;0;47;0;0;0;47
310470 Ataléia;0;0;0;0;0;0
310480 Augusto de Lima;2;0;0;0;0;2
310490 Baependi;71;0;0;0;0;71
310500 Baldim;1587;1703;1001;1520;748;6559
310510 Bambuí;0;0;0;0;0;0
310520 Bandeira;1539;1112;1588;1651;1224;7114
310530 Bandeira do Sul;0;0;0;0;0;0
310540 Barão de Cocais;171;152;0;0;0;323
310550 Barão de Monte Alto;0;0;0;0;0;0
310560 Barbacena;49046;59727;60777;40076;48863;258489
310570 Barra Longa;0;0;0;0;0;0
310590 Barroso;63;65;3;0;0;131
310600 Bela Vista de Minas;66;50;0;0;0;116
310610 Belmiro Braga;0;0;0;0;0;0
310620 Belo Horizonte;10289;13497;8491;4201;3481;39959
310630 Belo Oriente;29;13;0;0;141;183
310640 Belo Vale;0;0;0;0;0;0
310650 Berilo;0;0;0;0;1863;1863
310665 Berizal;0;0;0;0;0;0
310660 Bertópolis;9;0;0;0;0;9
310670 Betim;9110;5593;6571;6454;8209;35937
310680 Bias Fortes;0;0;0;0;0;0
310690 Bicas;0;0;0;0;0;0
310700 Biquinhas;4;0;0;0;0;4
310710 Boa Esperança;0;0;14620;5891;2337;22848
310720 Bocaina de Minas;0;0;0;0;0;0
310730 Bocaiúva;0;0;0;0;0;0
310740 Bom Despacho;375;291;233;160;0;1059
310750 Bom Jardim de Minas;0;0;0;0;0;0
310760 Bom Jesus da Penha;0;0;0;0;0;0
310770 Bom Jesus do Amparo;55;11;0;0;0;66
310780 Bom Jesus do Galho;21;0;0;0;0;21
310790 Bom Repouso;0;0;0;0;0;0
310800 Bom Sucesso;75;0;0;0;0;75
310810 Bonfim;0;0;0;0;0;0
310820 Bonfinópolis de Minas;0;0;0;0;0;0
310825 Bonito de Minas;0;0;0;0;480;480
310830 Borda da Mata;0;0;0;0;0;0
310840 Botelhos;38;6;0;0;0;44
310850 Botumirim;0;0;0;0;0;0
310870 Brás Pires;0;0;0;0;0;0
310855 Brasilândia de Minas;0;0;0;0;0;0
310860 Brasília de Minas;0;0;0;0;0;0
310880 Braúnas;0;7;0;0;0;7
310890 Brazópolis;67;38;0;0;0;105
310900 Brumadinho;249;220;40;36;0;545
310910 Bueno Brandão;0;0;0;0;0;0
310920 Buenópolis;0;0;0;0;0;0
310925 Bugre;0;0;0;0;0;0
310930 Buritis;1364;143;190;1818;1974;5489
310940 Buritizeiro;0;0;0;0;7729;7729
310945 Cabeceira Grande;0;0;0;0;0;0
310950 Cabo Verde;0;0;0;0;0;0
310960 Cachoeira da Prata;0;0;0;0;0;0
310970 Cachoeira de Minas;0;0;0;0;0;0
310270 Cachoeira de Pajeú;0;0;0;0;0;0
310980 Cachoeira Dourada;0;0;0;0;0;0
310990 Caetanópolis;0;0;0;0;0;0
311000 Caeté;0;0;0;0;0;0
311010 Caiana;0;0;0;0;0;0
311020 Cajuri;0;0;0;0;0;0
311030 Caldas;0;0;0;0;0;0
311040 Camacho;15;6;0;0;0;21
311050 Camanducaia;0;20;0;0;0;20
311060 Cambuí;0;0;0;0;0;0
311070 Cambuquira;76;28;0;0;0;104
311080 Campanário;0;0;0;0;0;0
311090 Campanha;0;0;0;0;0;0
311100 Campestre;2;0;0;0;0;2
311110 Campina Verde;0;0;0;0;0;0
311115 Campo Azul;0;0;0;0;0;0
311120 Campo Belo;10639;12954;13914;9453;17654;64614
311130 Campo do Meio;0;0;0;0;0;0
311140 Campo Florido;0;0;0;0;0;0
311150 Campos Altos;0;0;0;0;0;0
311160 Campos Gerais;0;0;0;0;0;0
311190 Cana Verde;0;0;0;0;0;0
311170 Canaã;0;0;0;0;0;0
311180 Canápolis;0;23;0;0;0;23
311200 Candeias;148;101;0;0;0;249
311205 Cantagalo;0;0;0;0;0;0
311210 Caparaó;0;0;0;0;0;0
311220 Capela Nova;0;0;0;0;0;0
311230 Capelinha;0;390;1553;3534;955;6432
311240 Capetinga;10;1;0;0;0;11
311250 Capim Branco;21;6;0;0;0;27
311260 Capinópolis;86;89;0;0;0;175
311265 Capitão Andrade;0;0;0;0;0;0
311270 Capitão Enéas;0;0;0;0;0;0
311280 Capitólio;28;0;0;0;0;28
311290 Caputira;44;0;0;0;0;44
311300 Caraí;67;6;0;0;0;73
311310 Caranaíba;0;0;0;0;0;0
311320 Carandaí;159;25;0;0;0;184
311330 Carangola;99;260;13083;4311;0;17753
311340 Caratinga;166;226;0;0;0;392
311350 Carbonita;0;0;0;0;0;0
311360 Careaçu;0;0;0;0;0;0
311370 Carlos Chagas;91;0;0;0;0;91
311380 Carmésia;0;0;0;0;0;0
311390 Carmo da Cachoeira;40;40;0;0;0;80
311400 Carmo da Mata;0;0;0;0;0;0
311410 Carmo de Minas;0;0;0;0;0;0
311420 Carmo do Cajuru;131;130;0;0;0;261
311430 Carmo do Paranaíba;2522;3960;6154;16671;9054;38361
311440 Carmo do Rio Claro;0;0;0;0;0;0
311450 Carmópolis de Minas;14;0;0;0;0;14
311455 Carneirinho;0;0;0;0;0;0
311460 Carrancas;0;0;0;0;0;0
311470 Carvalhópolis;10;4;0;0;0;14
311480 Carvalhos;0;0;0;0;0;0
311490 Casa Grande;0;0;0;0;0;0
311500 Cascalho Rico;11;26;0;0;0;37
311510 Cássia;165;150;0;0;0;315
311530 Cataguases;694;0;0;0;0;694
311535 Catas Altas;23;32;284;205;151;695
311540 Catas Altas da Noruega;0;0;0;0;0;0
311545 Catuji;13;0;0;0;0;13
311547 Catuti;0;0;0;0;0;0
311550 Caxambu;0;0;0;0;0;0
311560 Cedro do Abaeté;6;0;0;0;0;6
311570 Central de Minas;0;0;0;0;0;0
311580 Centralina;0;0;0;0;0;0
311590 Chácara;1;0;0;0;0;1
311600 Chalé;34;0;0;0;0;34
311610 Chapada do Norte;0;0;0;0;0;0
311615 Chapada Gaúcha;0;0;0;0;0;0
311620 Chiador;0;0;0;0;0;0
311630 Cipotânea;5;0;0;0;0;5
311640 Claraval;5;0;0;0;0;5
311650 Claro dos Poções;0;0;0;0;0;0
311660 Cláudio;0;0;0;0;0;0
311670 Coimbra;0;0;0;0;0;0
311680 Coluna;0;0;0;0;0;0
311690 Comendador Gomes;0;0;0;0;0;0
311700 Comercinho;54;45;0;0;0;99
311710 Conceição da Aparecida;0;0;0;0;0;0
311520 Conceição da Barra de Minas;0;0;0;0;0;0
311730 Conceição das Alagoas;0;0;0;0;0;0
311720 Conceição das Pedras;0;0;0;0;0;0
311740 Conceição de Ipanema;0;0;0;0;0;0
311750 Conceição do Mato Dentro;0;0;200;410;12;622
311760 Conceição do Pará;7;0;0;0;0;7
311770 Conceição do Rio Verde;0;0;0;0;0;0
311780 Conceição dos Ouros;0;0;0;0;0;0
311783 Cônego Marinho;0;0;0;0;0;0
311787 Confins;76;0;0;0;0;76
311790 Congonhal;0;0;0;0;0;0
311800 Congonhas;2531;5477;13434;16489;9954;47885
311810 Congonhas do Norte;0;0;0;0;0;0
311820 Conquista;0;0;0;0;0;0
311830 Conselheiro Lafaiete;853;345;0;0;0;1198
311840 Conselheiro Pena;3932;5553;3885;1795;1473;16638
311850 Consolação;0;0;0;0;0;0
311860 Contagem;3785;3273;1517;0;539;9114
311870 Coqueiral;70;48;0;0;0;118
311880 Coração de Jesus;6779;5246;7151;8496;8837;36509
311890 Cordisburgo;0;0;0;0;0;0
311900 Cordislândia;0;0;0;0;0;0
311910 Corinto;31475;25299;12382;97;1614;70867
311920 Coroaci;14;0;0;0;0;14
311930 Coromandel;44786;41924;46492;20848;15055;169105
311940 Coronel Fabriciano;7441;10947;8400;5042;1408;33238
311950 Coronel Murta;0;0;0;0;0;0
311960 Coronel Pacheco;0;0;0;0;0;0
311970 Coronel Xavier Chaves;0;0;0;0;0;0
311980 Córrego Danta;0;0;0;0;0;0
311990 Córrego do Bom Jesus;0;0;0;0;0;0
311995 Córrego Fundo;0;0;0;0;0;0
312000 Córrego Novo;0;0;0;0;0;0
312010 Couto de Magalhães de Minas;0;0;0;0;0;0
312015 Crisólita;33;0;0;0;0;33
312020 Cristais;62;30;0;0;0;92
312030 Cristália;0;0;0;0;0;0
312040 Cristiano Otoni;0;0;0;0;0;0
312050 Cristina;0;0;0;0;0;0
312060 Crucilândia;0;0;0;0;0;0
312070 Cruzeiro da Fortaleza;0;0;0;0;0;0
312080 Cruzília;198;0;0;0;0;198
312083 Cuparaque;0;0;0;0;0;0
312087 Curral de Dentro;0;0;0;0;0;0
312090 Curvelo;286;0;0;0;0;286
312100 Datas;102;67;55;65;22;311
312110 Delfim Moreira;43;30;0;0;0;73
312120 Delfinópolis;41;49;0;0;0;90
312125 Delta;0;0;0;0;0;0
312130 Descoberto;14;4;0;0;0;18
312140 Desterro de Entre Rios;7;12;0;0;0;19
312150 Desterro do Melo;33;34;0;0;0;67
312160 Diamantina;114743;34322;18470;0;0;167535
312170 Diogo de Vasconcelos;0;0;0;0;0;0
312180 Dionísio;0;0;0;0;0;0
312190 Divinésia;0;0;0;0;0;0
312200 Divino;133;24;0;0;0;157
312210 Divino das Laranjeiras;0;0;0;0;0;0
312220 Divinolândia de Minas;0;0;0;0;0;0
312230 Divinópolis;94941;63834;59204;33286;45636;296901
312235 Divisa Alegre;8916;9149;9263;9443;8530;45301
312240 Divisa Nova;0;0;0;0;0;0
312245 Divisópolis;43;81;0;0;0;124
312247 Dom Bosco;0;0;0;0;0;0
312250 Dom Cavati;0;0;0;0;0;0
312260 Dom Joaquim;131;786;2650;5256;3171;11994
312270 Dom Silvério;0;0;0;0;0;0
312280 Dom Viçoso;0;0;0;0;0;0
312290 Dona Eusébia;0;0;0;0;0;0
312300 Dores de Campos;0;0;0;0;0;0
312310 Dores de Guanhães;18;10;4;0;0;32
312320 Dores do Indaiá;0;0;0;0;0;0
312330 Dores do Turvo;0;0;0;0;0;0
312340 Doresópolis;0;0;0;0;0;0
312350 Douradoquara;0;0;0;0;0;0
312352 Durandé;3;0;0;0;0;3
312360 Elói Mendes;12;13;0;0;0;25
312370 Engenheiro Caldas;0;0;0;0;0;0
312380 Engenheiro Navarro;44;21;0;0;0;65
312385 Entre Folhas;8;25;0;0;0;33
312390 Entre Rios de Minas;0;0;0;0;0;0
312400 Ervália;0;0;0;0;0;0
312410 Esmeraldas;129;72;0;0;0;201
312420 Espera Feliz;12;0;0;0;0;12
312430 Espinosa;0;0;0;0;0;0
312440 Espírito Santo do Dourado;0;0;0;0;0;0
312450 Estiva;0;0;0;0;0;0
312460 Estrela Dalva;0;0;0;0;0;0
312470 Estrela do Indaiá;0;0;0;0;0;0
312480 Estrela do Sul;0;0;0;0;0;0
312490 Eugenópolis;0;0;0;0;0;0
312500 Ewbank da Câmara;0;0;0;0;0;0
312510 Extrema;0;0;0;0;0;0
312520 Fama;0;0;0;0;0;0
312530 Faria Lemos;300;0;0;0;0;300
312540 Felício dos Santos;0;0;0;0;0;0
312560 Felisburgo;30;0;0;1;0;31
312570 Felixlândia;8394;8861;13211;2336;1931;34733
312580 Fernandes Tourinho;0;0;0;0;0;0
312590 Ferros;1027;2036;2660;360;403;6486
312595 Fervedouro;185;129;84;299;181;878
312600 Florestal;0;0;0;0;0;0
312610 Formiga;299;205;0;0;0;504
312620 Formoso;0;1599;57;275;416;2347
312630 Fortaleza de Minas;21;9;0;0;0;30
312640 Fortuna de Minas;32;199;168;139;293;831
312650 Francisco Badaró;2102;168;0;424;663;3357
312660 Francisco Dumont;0;0;0;0;0;0
312670 Francisco Sá;0;0;0;0;0;0
312675 Franciscópolis;0;0;0;0;0;0
312680 Frei Gaspar;0;0;0;0;0;0
312690 Frei Inocêncio;0;0;0;0;0;0
312695 Frei Lagonegro;23;14;0;0;0;37
312700 Fronteira;0;0;0;0;0;0
312705 Fronteira dos Vales;15;0;0;0;0;15
312707 Fruta de Leite;0;0;0;0;0;0
312710 Frutal;220;140;0;0;0;360
312720 Funilândia;0;0;0;0;0;0
312730 Galiléia;0;0;0;0;0;0
312733 Gameleiras;0;0;0;0;0;0
312735 Glaucilândia;0;0;0;0;0;0
312737 Goiabeira;0;0;0;0;0;0
312738 Goianá;0;0;0;0;0;0
312740 Gonçalves;0;0;0;0;0;0
312750 Gonzaga;64;25;0;0;0;89
312760 Gouveia;0;0;0;0;0;0
312770 Governador Valadares;110397;98390;84679;44546;67176;405188
312780 Grão Mogol;0;0;0;0;0;0
312790 Grupiara;0;0;0;0;0;0
312800 Guanhães;555;76;0;0;0;631
312810 Guapé;0;0;0;0;0;0
312820 Guaraciaba;0;0;0;0;0;0
312825 Guaraciama;936;203;0;0;0;1139
312830 Guaranésia;0;0;0;0;0;0
312840 Guarani;0;0;0;0;0;0
312850 Guarará;0;0;0;0;0;0
312860 Guarda-Mor;34;34;0;0;0;68
312870 Guaxupé;449;0;0;22339;32647;55435
312880 Guidoval;0;0;0;0;0;0
312890 Guimarânia;0;0;0;0;0;0
312900 Guiricema;0;0;0;0;0;0
312910 Gurinhatã;23;3;0;0;0;26
312920 Heliodora;0;0;0;0;0;0
312930 Iapu;0;0;0;0;0;0
312940 Ibertioga;7456;7826;9421;5707;2929;33339
312950 Ibiá;0;0;0;13069;35504;48573
312960 Ibiaí;0;0;0;0;0;0
312965 Ibiracatu;26;16;0;0;0;42
312970 Ibiraci;91;50;55;59;24;279
312980 Ibirité;1331;1004;408;786;396;3925
312990 Ibitiúra de Minas;0;2;0;0;0;2
313000 Ibituruna;0;0;0;0;0;0
313005 Icaraí de Minas;546;0;85;311;557;1499
313010 Igarapé;242;184;37;45;0;508
313020 Igaratinga;48;67;0;0;0;115
313030 Iguatama;0;0;0;0;0;0
313040 Ijaci;0;0;0;0;0;0
313050 Ilicínea;0;0;0;0;0;0
313055 Imbé de Minas;4;0;0;0;0;4
313060 Inconfidentes;0;0;0;0;0;0
313065 Indaiabira;14;18;0;0;0;32
313070 Indianópolis;0;0;0;0;0;0
313080 Ingaí;0;0;0;0;0;0
313090 Inhapim;0;0;0;0;0;0
313100 Inhaúma;0;0;0;0;0;0
313110 Inimutaba;4962;1429;4072;0;34;10497
313115 Ipaba;9;0;0;0;0;9
313120 Ipanema;5172;2532;3357;5104;2710;18875
313130 Ipatinga;70889;77618;91919;47419;52360;340205
313140 Ipiaçu;0;0;0;0;0;0
313150 Ipuiúna;2;0;0;0;0;2
313160 Iraí de Minas;0;0;0;0;0;0
313170 Itabira;685;13176;25046;21872;18716;79495
313180 Itabirinha;0;0;0;0;0;0
313190 Itabirito;15880;11872;8384;4158;6772;47066
313200 Itacambira;0;0;0;0;0;0
313210 Itacarambi;107921;66612;74608;56295;56171;361607
313220 Itaguara;116;76;0;0;0;192
313230 Itaipé;0;0;0;0;0;0
313240 Itajubá;0;133;15;17;0;165
313250 Itamarandiba;0;0;0;0;0;0
313260 Itamarati de Minas;0;0;0;0;0;0
313270 Itambacuri;0;0;0;0;0;0
313280 Itambé do Mato Dentro;0;0;0;0;0;0
313290 Itamogi;42;13;0;0;0;55
313300 Itamonte;0;0;0;0;0;0
313310 Itanhandu;0;0;0;0;0;0
313320 Itanhomi;0;0;0;0;0;0
313330 Itaobim;10224;9266;16192;0;0;35682
313340 Itapagipe;0;0;0;0;0;0
313350 Itapecerica;0;0;0;0;0;0
313360 Itapeva;0;0;0;0;0;0
313370 Itatiaiuçu;109;106;0;0;0;215
313375 Itaú de Minas;23;0;2;0;0;25
313380 Itaúna;15203;18895;20067;15444;12945;82554
313390 Itaverava;0;0;0;0;0;0
313400 Itinga;3188;3477;2749;6815;5584;21813
313410 Itueta;0;0;0;0;0;0
313420 Ituiutaba;8271;5890;10694;2633;1062;28550
313430 Itumirim;0;0;0;0;0;0
313440 Iturama;0;0;0;0;0;0
313450 Itutinga;8;0;0;0;0;8
313460 Jaboticatubas;0;1717;1388;1851;4926;9882
313470 Jacinto;0;0;0;0;0;0
313480 Jacuí;0;0;0;0;0;0
313490 Jacutinga;0;0;0;0;0;0
313500 Jaguaraçu;0;0;0;0;0;0
313505 Jaíba;1057;654;705;207;0;2623
313507 Jampruca;0;0;0;0;0;0
313510 Janaúba;23775;24795;17246;9934;33583;109333
313520 Januária;36;63;0;0;0;99
313530 Japaraíba;19;18;0;0;0;37
313535 Japonvar;0;0;734;1306;2480;4520
313540 Jeceaba;15;10;0;0;0;25
313545 Jenipapo de Minas;0;4222;5499;5037;3398;18156
313550 Jequeri;0;0;0;0;0;0
313560 Jequitaí;0;0;0;0;0;0
313570 Jequitibá;3093;2209;2772;4170;3668;15912
313580 Jequitinhonha;12431;17937;5584;4928;0;40880
313590 Jesuânia;0;0;0;0;0;0
313600 Joaíma;0;0;0;0;0;0
313610 Joanésia;0;0;0;0;0;0
313620 João Monlevade;457;360;0;0;0;817
313630 João Pinheiro;0;0;0;0;0;0
313640 Joaquim Felício;0;0;0;0;0;0
313650 Jordânia;431;282;0;1031;937;2681
313652 José Gonçalves de Minas;0;0;0;0;0;0
313655 José Raydan;0;0;0;0;0;0
313657 Josenópolis;0;0;0;0;0;0
313665 Juatuba;108;90;5;0;0;203
313670 Juiz de Fora;75;0;0;0;0;75
313680 Juramento;0;0;0;0;0;0
313690 Juruaia;0;0;0;0;0;0
313695 Juvenília;0;0;0;0;0;0
313700 Ladainha;0;0;0;0;0;0
313710 Lagamar;5;23;0;0;0;28
313720 Lagoa da Prata;143;164;0;0;0;307
313730 Lagoa dos Patos;19;0;0;0;0;19
313740 Lagoa Dourada;236;263;0;0;0;499
313750 Lagoa Formosa;2912;1211;1298;1062;0;6483
313753 Lagoa Grande;0;0;0;0;0;0
313760 Lagoa Santa;0;0;0;0;0;0
313770 Lajinha;24;23;0;0;0;47
313780 Lambari;141;72;0;0;0;213
313790 Lamim;0;0;0;0;0;0
313800 Laranjal;0;0;0;0;0;0
313810 Lassance;0;0;0;0;0;0
313820 Lavras;0;0;0;0;0;0
313830 Leandro Ferreira;0;0;0;0;0;0
313835 Leme do Prado;0;0;0;0;0;0
313840 Leopoldina;0;0;1000;0;0;1000
313850 Liberdade;0;0;0;0;0;0
313860 Lima Duarte;13;4;0;0;0;17
313862 Limeira do Oeste;0;0;0;0;0;0
313865 Lontra;0;0;0;0;0;0
313867 Luisburgo;59;11;0;0;0;70
313868 Luislândia;0;0;0;0;0;0
313870 Luminárias;0;0;0;0;0;0
313880 Luz;161;116;0;0;0;277
313890 Machacalis;0;0;0;0;0;0
313900 Machado;144;114;0;0;0;258
313910 Madre de Deus de Minas;0;0;0;0;0;0
313920 Malacacheta;0;0;0;0;0;0
313925 Mamonas;59;25;0;0;0;84
313930 Manga;108;58;1962;1532;4085;7745
313940 Manhuaçu;105539;86808;108358;52817;88831;442353
313950 Manhumirim;136;0;0;0;0;136
313960 Mantena;10469;24773;36516;20186;36559;128503
313980 Mar de Espanha;0;0;0;0;0;0
313970 Maravilhas;0;0;0;0;0;0
313990 Maria da Fé;78;45;0;0;0;123
314000 Mariana;0;23;0;0;0;23
314010 Marilac;0;0;0;0;0;0
314015 Mário Campos;125;0;0;0;0;125
314020 Maripá de Minas;0;0;0;0;0;0
314030 Marliéria;0;0;0;0;0;0
314040 Marmelópolis;0;0;0;0;0;0
314050 Martinho Campos;0;0;0;0;0;0
314053 Martins Soares;0;0;0;0;0;0
314055 Mata Verde;0;0;0;0;0;0
314060 Materlândia;0;0;0;0;0;0
314070 Mateus Leme;0;0;0;0;0;0
317150 Mathias Lobato;9;0;0;0;0;9
314080 Matias Barbosa;52;56;0;0;0;108
314085 Matias Cardoso;122;271;367;574;453;1787
314090 Matipó;55;0;0;0;0;55
314100 Mato Verde;0;0;0;0;0;0
314110 Matozinhos;0;0;0;0;0;0
314120 Matutina;0;0;0;0;0;0
314130 Medeiros;0;0;0;0;0;0
314140 Medina;11084;21961;38273;20543;25921;117782
314150 Mendes Pimentel;0;0;0;0;0;0
314160 Mercês;0;0;0;0;0;0
314170 Mesquita;0;0;0;0;0;0
314180 Minas Novas;13620;12672;10772;11722;9924;58710
314190 Minduri;0;0;0;0;0;0
314200 Mirabela;0;0;0;0;0;0
314210 Miradouro;0;0;0;0;1544;1544
314220 Miraí;0;0;0;0;0;0
314225 Miravânia;0;0;0;0;0;0
314230 Moeda;0;0;0;0;0;0
314240 Moema;43;0;0;0;0;43
314250 Monjolos;0;0;0;0;0;0
314260 Monsenhor Paulo;0;0;0;0;0;0
314270 Montalvânia;0;0;0;0;0;0
314280 Monte Alegre de Minas;80;112;0;0;0;192
314290 Monte Azul;6774;9187;10758;9011;11645;47375
314300 Monte Belo;114;73;0;0;0;187
314310 Monte Carmelo;19734;26498;42063;8708;19241;116244
314315 Monte Formoso;0;0;0;0;0;0
314320 Monte Santo de Minas;0;0;0;0;0;0
314340 Monte Sião;0;0;0;0;0;0
314330 Montes Claros;50369;47347;61965;37199;56324;253204
314345 Montezuma;0;0;0;0;0;0
314350 Morada Nova de Minas;967;1125;14;20;68;2194
314360 Morro da Garça;0;0;0;0;0;0
314370 Morro do Pilar;572;421;101;0;0;1094
314380 Munhoz;0;0;0;0;0;0
314390 Muriaé;0;0;0;0;0;0
314400 Mutum;232;189;180;36;0;637
314410 Muzambinho;0;0;0;0;0;0
314420 Nacip Raydan;4;2;0;0;0;6
314430 Nanuque;49;16;0;0;0;65
314435 Naque;31;0;0;0;0;31
314437 Natalândia;0;0;0;0;0;0
314440 Natércia;0;0;0;0;0;0
314450 Nazareno;17;0;0;0;0;17
314460 Nepomuceno;0;0;0;0;0;0
314465 Ninheira;21;0;0;0;0;21
314467 Nova Belém;0;0;0;0;0;0
314470 Nova Era;378;230;1437;6624;1948;10617
314480 Nova Lima;377;385;0;0;0;762
314490 Nova Módica;0;0;0;0;0;0
314500 Nova Ponte;0;0;0;0;0;0
314505 Nova Porteirinha;0;0;0;0;0;0
314510 Nova Resende;0;0;0;0;0;0
314520 Nova Serrana;974;648;0;0;0;1622
313660 Nova União;15;0;0;0;0;15
314530 Novo Cruzeiro;35;69;0;0;0;104
314535 Novo Oriente de Minas;13;0;0;0;0;13
314537 Novorizonte;0;0;0;0;0;0
314540 Olaria;0;0;0;0;0;0
314545 Olhos-d'Água;0;0;0;0;0;0
314550 Olímpio Noronha;0;0;0;0;0;0
314560 Oliveira;19;90;0;0;0;109
314570 Oliveira Fortes;0;0;0;0;0;0
314580 Onça de Pitangui;0;0;0;0;0;0
314585 Oratórios;26;15;0;0;0;41
314587 Orizânia;0;0;0;0;0;0
314590 Ouro Branco;0;0;0;0;0;0
314600 Ouro Fino;0;0;0;0;0;0
314610 Ouro Preto;159;1806;13;2092;5986;10056
314620 Ouro Verde de Minas;6;0;0;0;0;6
314625 Padre Carvalho;0;0;0;0;0;0
314630 Padre Paraíso;86;56;0;0;0;142
314655 Pai Pedro;0;0;504;3296;1230;5030
314640 Paineiras;21;24;0;0;0;45
314650 Pains;0;0;0;0;0;0
314660 Paiva;2;0;0;0;0;2
314670 Palma;0;0;0;0;0;0
314675 Palmópolis;2937;7186;7553;5827;7465;30968
314690 Papagaios;127;54;0;0;0;181
314710 Pará de Minas;30789;7819;0;12103;63146;113857
314700 Paracatu;0;0;0;0;105;105
314720 Paraguaçu;127;114;0;0;0;241
314730 Paraisópolis;0;0;0;0;0;0
314740 Paraopeba;6330;4468;3662;4495;2418;21373
314760 Passa Quatro;0;0;0;0;0;0
314770 Passa Tempo;28;30;0;0;0;58
314780 Passa-Vinte;0;0;0;0;0;0
314750 Passabém;0;0;0;0;0;0
314790 Passos;52715;52223;98358;39024;37035;279355
314795 Patis;0;0;0;0;0;0
314800 Patos de Minas;55681;53901;58701;43955;32399;244637
314810 Patrocínio;12081;14785;20759;11575;9388;68588
314820 Patrocínio do Muriaé;0;0;0;0;0;0
314830 Paula Cândido;36;0;0;0;0;36
314840 Paulistas;15;15;0;0;0;30
314850 Pavão;27;13;0;0;0;40
314860 Peçanha;0;0;0;0;0;0
314870 Pedra Azul;26594;20839;31605;27145;23292;129475
314875 Pedra Bonita;0;0;0;0;0;0
314880 Pedra do Anta;19;14;0;0;0;33
314890 Pedra do Indaiá;0;0;0;0;0;0
314900 Pedra Dourada;0;0;0;0;31;31
314910 Pedralva;11;0;0;0;0;11
314915 Pedras de Maria da Cruz;0;0;0;0;0;0
314920 Pedrinópolis;0;0;0;0;0;0
314930 Pedro Leopoldo;65;1125;478;4;12;1684
314940 Pedro Teixeira;8;2;0;0;0;10
314950 Pequeri;0;0;0;0;0;0
314960 Pequi;0;0;0;0;0;0
314970 Perdigão;0;0;0;0;0;0
314980 Perdizes;207;166;0;0;0;373
314990 Perdões;732;873;563;283;473;2924
314995 Periquito;12;20;0;0;0;32
315000 Pescador;1;0;0;0;0;1
315010 Piau;0;0;0;0;0;0
315015 Piedade de Caratinga;109;0;0;0;0;109
315020 Piedade de Ponte Nova;0;0;0;0;0;0
315030 Piedade do Rio Grande;0;0;0;0;0;0
315040 Piedade dos Gerais;0;0;0;0;0;0
315050 Pimenta;52;19;0;0;0;71
315053 Pingo-d'Água;1;0;0;0;0;1
315057 Pintópolis;0;0;0;0;0;0
315060 Piracema;0;0;0;0;0;0
315070 Pirajuba;0;0;0;0;0;0
315080 Piranga;0;0;0;0;0;0
315090 Piranguçu;0;0;0;0;0;0
315100 Piranguinho;0;0;0;0;0;0
315110 Pirapetinga;0;0;0;0;0;0
315120 Pirapora;101092;85571;116801;54828;50722;409014
315130 Piraúba;0;0;0;0;0;0
315140 Pitangui;0;0;0;0;0;0
315150 Piumhi;28;20;0;0;0;48
315160 Planura;0;0;0;0;0;0
315170 Poço Fundo;95;95;0;0;0;190
315180 Poços de Caldas;64;0;0;0;0;64
315190 Pocrane;0;0;0;0;0;0
315200 Pompéu;323;1927;533;11480;2637;16900
315210 Ponte Nova;15372;16422;15239;7767;10475;65275
315213 Ponto Chique;0;0;0;0;0;0
315217 Ponto dos Volantes;4522;752;0;0;0;5274
315220 Porteirinha;3128;125;270;1908;1375;6806
315230 Porto Firme;0;0;0;0;0;0
315240 Poté;44;28;0;0;0;72
315250 Pouso Alegre;62;0;0;0;0;62
315260 Pouso Alto;0;0;0;0;0;0
315270 Prados;134;0;0;0;0;134
315280 Prata;61;44;0;0;0;105
315290 Pratápolis;9;6;0;0;0;15
315300 Pratinha;23;13;0;0;0;36
315310 Presidente Bernardes;0;0;0;0;0;0
315320 Presidente Juscelino;0;0;0;0;0;0
315330 Presidente Kubitschek;0;0;0;0;0;0
315340 Presidente Olegário;0;0;0;0;0;0
315360 Prudente de Morais;0;0;0;0;0;0
315370 Quartel Geral;0;0;0;0;0;0
315380 Queluzito;5;0;0;0;0;5
315390 Raposos;1;0;0;0;0;1
315400 Raul Soares;143;59;0;0;0;202
315410 Recreio;14;37;0;0;0;51
315415 Reduto;0;0;0;0;0;0
315420 Resende Costa;0;0;0;7;82;89
315430 Resplendor;146;942;49;246;51;1434
315440 Ressaquinha;0;0;0;0;0;0
315445 Riachinho;0;0;0;0;0;0
315450 Riacho dos Machados;0;2;0;0;0;2
315460 Ribeirão das Neves;47641;50796;52534;52518;95560;299049
315470 Ribeirão Vermelho;0;0;0;0;0;0
315480 Rio Acima;0;0;0;0;0;0
315490 Rio Casca;32;68;0;0;0;100
315510 Rio do Prado;2636;3904;7170;3600;5040;22350
315500 Rio Doce;0;0;0;0;0;0
315520 Rio Espera;4;0;0;0;0;4
315530 Rio Manso;0;0;0;0;0;0
315540 Rio Novo;0;0;0;0;0;0
315550 Rio Paranaíba;0;0;0;0;0;0
315560 Rio Pardo de Minas;281;232;0;0;0;513
315570 Rio Piracicaba;23;17;0;0;0;40
315580 Rio Pomba;0;0;0;0;0;0
315590 Rio Preto;0;0;0;0;0;0
315600 Rio Vermelho;0;0;0;0;0;0
315610 Ritápolis;0;0;0;0;0;0
315620 Rochedo de Minas;0;0;0;0;0;0
315630 Rodeiro;0;0;0;0;0;0
315640 Romaria;0;0;0;0;0;0
315645 Rosário da Limeira;0;0;0;0;0;0
315650 Rubelita;0;0;0;0;0;0
315660 Rubim;0;3;0;0;0;3
315670 Sabará;0;0;0;0;0;0
315680 Sabinópolis;52;42;267;2806;0;3167
315690 Sacramento;279;158;0;0;36235;36672
315700 Salinas;44937;57315;67861;47205;56324;273642
315710 Salto da Divisa;12;15;0;0;0;27
315720 Santa Bárbara;42;31;0;0;0;73
315725 Santa Bárbara do Leste;10;0;0;0;0;10
315727 Santa Bárbara do Monte Verde;0;0;0;0;0;0
315730 Santa Bárbara do Tugúrio;0;0;0;0;0;0
315733 Santa Cruz de Minas;1;1;0;0;0;2
315737 Santa Cruz de Salinas;0;0;0;0;0;0
315740 Santa Cruz do Escalvado;0;0;0;0;0;0
315750 Santa Efigênia de Minas;0;0;0;0;0;0
315760 Santa Fé de Minas;0;0;0;0;0;0
315765 Santa Helena de Minas;8;15;0;0;0;23
315770 Santa Juliana;0;0;0;0;0;0
315780 Santa Luzia;13500;2152;0;0;0;15652
315790 Santa Margarida;155;0;0;0;0;155
315800 Santa Maria de Itabira;3;26;0;0;0;29
315810 Santa Maria do Salto;0;0;0;0;0;0
315820 Santa Maria do Suaçuí;0;0;0;0;0;0
315920 Santa Rita de Caldas;33;0;0;0;0;33
315940 Santa Rita de Ibitipoca;0;0;0;0;0;0
315930 Santa Rita de Jacutinga;68;18;320;92;199;697
315935 Santa Rita de Minas;12;8;0;0;0;20
315950 Santa Rita do Itueto;24;0;0;0;0;24
315960 Santa Rita do Sapucaí;179;88;0;0;0;267
315970 Santa Rosa da Serra;8;0;0;0;0;8
315980 Santa Vitória;125;118;109;132;0;484
315830 Santana da Vargem;0;0;0;0;0;0
315840 Santana de Cataguases;0;0;0;0;0;0
315850 Santana de Pirapama;1234;1281;962;871;1058;5406
315860 Santana do Deserto;0;0;0;0;0;0
315870 Santana do Garambéu;0;0;0;0;0;0
315880 Santana do Jacaré;0;0;0;0;0;0
315890 Santana do Manhuaçu;0;0;0;0;0;0
315895 Santana do Paraíso;21071;18249;20584;10759;13585;84248
315900 Santana do Riacho;3;0;0;0;0;3
315910 Santana dos Montes;14;0;0;0;0;14
315990 Santo Antônio do Amparo;100;112;0;0;0;212
316000 Santo Antônio do Aventureiro;0;0;0;0;0;0
316010 Santo Antônio do Grama;0;0;0;0;0;0
316020 Santo Antônio do Itambé;0;0;0;0;0;0
316030 Santo Antônio do Jacinto;0;0;0;2086;6754;8840
316040 Santo Antônio do Monte;0;0;0;0;0;0
316045 Santo Antônio do Retiro;0;0;0;0;0;0
316050 Santo Antônio do Rio Abaixo;0;0;0;0;0;0
316060 Santo Hipólito;0;0;0;0;0;0
316070 Santos Dumont;0;0;0;0;0;0
316080 São Bento Abade;50;25;0;0;0;75
316090 São Brás do Suaçuí;0;0;0;0;0;0
316095 São Domingos das Dores;0;0;0;0;0;0
316100 São Domingos do Prata;11811;23353;31253;18213;19060;103690
316105 São Félix de Minas;0;0;0;0;0;0
316110 São Francisco;0;280;0;0;0;280
316120 São Francisco de Paula;71;17;0;0;0;88
316130 São Francisco de Sales;0;0;0;0;14;14
316140 São Francisco do Glória;0;0;0;0;0;0
316150 São Geraldo;0;0;0;0;0;0
316160 São Geraldo da Piedade;0;0;0;0;0;0
316165 São Geraldo do Baixio;0;0;0;0;0;0
316170 São Gonçalo do Abaeté;561;281;331;403;222;1798
316180 São Gonçalo do Pará;46;26;0;0;0;72
316190 São Gonçalo do Rio Abaixo;73;82;0;0;0;155
312550 São Gonçalo do Rio Preto;0;0;0;0;0;0
316200 São Gonçalo do Sapucaí;0;0;0;0;0;0
316210 São Gotardo;6454;7343;6235;4766;4534;29332
316220 São João Batista do Glória;0;0;0;0;0;0
316225 São João da Lagoa;42;30;0;0;0;72
316230 São João da Mata;0;0;0;0;0;0
316240 São João da Ponte;0;0;2163;3187;1868;7218
316245 São João das Missões;132;51;0;0;0;183
316250 São João del Rei;469;315;136;30;0;950
316255 São João do Manhuaçu;0;0;0;0;0;0
316257 São João do Manteninha;0;0;0;0;0;0
316260 São João do Oriente;0;0;0;0;0;0
316265 São João do Pacuí;18;12;0;0;0;30
316270 São João do Paraíso;0;0;0;0;0;0
316280 São João Evangelista;0;0;0;0;0;0
316290 São João Nepomuceno;67;40;154;44;1;306
316292 São Joaquim de Bicas;136;246;0;0;0;382
316294 São José da Barra;21;7;0;0;0;28
316295 São José da Lapa;80;28;0;0;0;108
316300 São José da Safira;13;11;0;0;0;24
316310 São José da Varginha;0;0;0;0;0;0
316320 São José do Alegre;3;0;0;0;0;3
316330 São José do Divino;0;0;0;0;0;0
316340 São José do Goiabal;0;0;0;0;0;0
316350 São José do Jacuri;0;0;0;0;0;0
316360 São José do Mantimento;333;55;0;0;0;388
316370 São Lourenço;1045;29;0;0;0;1074
316380 São Miguel do Anta;0;0;0;0;0;0
316390 São Pedro da União;0;0;0;0;0;0
316410 São Pedro do Suaçuí;0;0;0;0;0;0
316400 São Pedro dos Ferros;28;20;0;0;0;48
316420 São Romão;0;0;0;0;0;0
316430 São Roque de Minas;0;0;0;0;0;0
316440 São Sebastião da Bela Vista;0;0;0;0;0;0
316443 São Sebastião da Vargem Alegre;0;0;0;0;0;0
316447 São Sebastião do Anta;4;0;0;0;0;4
316450 São Sebastião do Maranhão;0;0;0;0;0;0
316460 São Sebastião do Oeste;0;0;0;0;0;0
316470 São Sebastião do Paraíso;121;2913;3867;2458;2003;11362
316480 São Sebastião do Rio Preto;0;0;0;0;0;0
316490 São Sebastião do Rio Verde;0;0;0;0;0;0
316520 São Thomé das Letras;0;0;0;0;0;0
316500 São Tiago;28;0;0;0;0;28
316510 São Tomás de Aquino;0;0;0;0;0;0
316530 São Vicente de Minas;0;0;0;0;0;0
316540 Sapucaí-Mirim;0;0;0;0;0;0
316550 Sardoá;0;0;0;0;0;0
316553 Sarzedo;73;197;0;0;0;270
316556 Sem-Peixe;4;0;0;0;0;4
316557 Senador Amaral;0;0;0;0;0;0
316560 Senador Cortes;0;0;0;0;0;0
316570 Senador Firmino;0;0;0;0;0;0
316580 Senador José Bento;0;0;0;0;0;0
316590 Senador Modestino Gonçalves;0;0;0;0;0;0
316600 Senhora de Oliveira;0;0;0;0;0;0
316610 Senhora do Porto;20;18;0;0;0;38
316620 Senhora dos Remédios;14;0;0;0;0;14
316630 Sericita;0;0;0;0;0;0
316640 Seritinga;0;0;0;0;0;0
316650 Serra Azul de Minas;0;0;0;0;0;0
316660 Serra da Saudade;0;0;0;0;0;0
316680 Serra do Salitre;0;0;0;623;1058;1681
316670 Serra dos Aimorés;5;9;0;0;0;14
316690 Serrania;0;0;0;0;0;0
316695 Serranópolis de Minas;42;3;0;0;0;45
316700 Serranos;0;0;0;0;0;0
316710 Serro;0;0;0;0;0;0
316720 Sete Lagoas;27539;28920;31193;25355;24805;137812
316555 Setubinha;18;34;0;0;0;52
316730 Silveirânia;0;0;0;0;0;0
316740 Silvianópolis;0;0;0;0;0;0
316750 Simão Pereira;0;0;0;0;0;0
316760 Simonésia;116;4;0;0;0;120
316770 Sobrália;0;0;0;0;0;0
316780 Soledade de Minas;0;0;0;0;0;0
316790 Tabuleiro;0;0;0;0;0;0
316800 Taiobeiras;0;0;0;0;0;0
316805 Taparuba;0;0;0;2113;197;2310
316810 Tapira;0;0;0;0;0;0
316820 Tapiraí;0;0;0;0;0;0
316830 Taquaraçu de Minas;0;0;0;0;0;0
316840 Tarumirim;233;270;305;89;163;1060
316850 Teixeiras;0;0;0;0;0;0
316860 Teófilo Otoni;0;23725;67507;0;36700;127932
316870 Timóteo;39946;44075;44231;7354;6927;142533
316880 Tiradentes;0;0;0;0;0;0
316890 Tiros;0;0;0;0;0;0
316900 Tocantins;104;0;0;0;0;104
316905 Tocos do Moji;16;6;0;0;0;22
316910 Toledo;0;0;0;0;0;0
316920 Tombos;0;0;0;0;0;0
316930 Três Corações;421;237;0;0;0;658
316935 Três Marias;102595;74776;100762;64834;96650;439617
316940 Três Pontas;46902;38887;35525;25139;29409;175862
316950 Tumiritinga;0;0;0;0;0;0
316960 Tupaciguara;198;43;0;0;0;241
316970 Turmalina;2010;0;0;0;0;2010
316980 Turvolândia;0;0;0;0;0;0
316990 Ubá;39248;44129;41960;27360;32021;184718
317000 Ubaí;0;0;0;0;0;0
317005 Ubaporanga;55;45;0;0;0;100
317010 Uberaba;0;0;6;46;166;218
317020 Uberlândia;60692;52381;82368;46878;78950;321269
317030 Umburatiba;15;0;0;0;0;15
317040 Unaí;11359;28968;39111;29749;32584;141771
317043 União de Minas;0;0;0;0;0;0
317047 Uruana de Minas;0;0;0;0;0;0
317050 Urucânia;69;57;0;0;0;126
317052 Urucuia;0;0;0;0;0;0
317057 Vargem Alegre;26;8;0;0;0;34
317060 Vargem Bonita;0;0;0;0;0;0
317065 Vargem Grande do Rio Pardo;47;29;0;0;0;76
317070 Varginha;1089;2;47;0;4;1142
317075 Varjão de Minas;0;0;0;0;0;0
317080 Várzea da Palma;224;182;0;0;0;406
317090 Varzelândia;0;0;0;0;0;0
317100 Vazante;0;0;0;0;0;0
317103 Verdelândia;70;56;0;0;0;126
317107 Veredinha;1467;787;670;1170;2653;6747
317110 Veríssimo;0;0;0;0;0;0
317115 Vermelho Novo;0;0;0;0;0;0
317120 Vespasiano;469;419;0;0;0;888
317130 Viçosa;280;183;0;0;8091;8554
317140 Vieiras;0;0;0;0;49;49
317160 Virgem da Lapa;0;2832;0;0;0;2832
317170 Virgínia;0;0;0;0;0;0
317180 Virginópolis;0;0;0;0;0;0
317190 Virgolândia;0;0;0;0;0;0
317200 Visconde do Rio Branco;0;0;0;0;0;0
317210 Volta Grande;0;0;0;0;0;0
317220 Wenceslau Braz;0;0;0;0;0;0
320010 Afonso Cláudio;20872;43923;44566;25977;12879;148217
320016 Água Doce do Norte;12;0;0;0;0;12
320013 Águia Branca;29;0;4002;2078;5712;11821
320020 Alegre;0;0;0;0;0;0
320030 Alfredo Chaves;0;0;0;0;0;0
320035 Alto Rio Novo;0;0;0;0;0;0
320040 Anchieta;12775;21181;12985;2870;5062;54873
320050 Apiacá;20;752;0;0;0;772
320060 Aracruz;44071;68648;106719;50312;51490;321240
320070 Atilio Vivacqua;0;0;0;0;0;0
320080 Baixo Guandu;31513;90745;93990;31625;31131;279004
320090 Barra de São Francisco;262;88149;190957;99607;17855;396830
320100 Boa Esperança;0;0;472;26276;55918;82666
320110 Bom Jesus do Norte;0;4978;8241;5419;5565;24203
320115 Brejetuba;1925;8260;7851;3229;34968;56233
320120 Cachoeiro de Itapemirim;35111;32379;35330;14399;17473;134692
320130 Cariacica;97038;6986;2516;4451;0;110991
320140 Castelo;170;26475;38104;20591;26313;111653
320150 Colatina;147125;157646;134692;83316;115217;637996
320160 Conceição da Barra;35774;115721;136656;63788;80078;432017
320170 Conceição do Castelo;37299;32737;35560;22478;15980;144054
320180 Divino de São Lourenço;0;0;0;0;0;0
320190 Domingos Martins;10345;12232;13796;4620;18713;59706
320200 Dores do Rio Preto;0;0;6197;4169;3098;13464
320210 Ecoporanga;22;27;0;0;0;49
320220 Fundão;2;0;0;0;0;2
320225 Governador Lindenberg;20073;49686;43794;24628;33931;172112
320230 Guaçuí;13441;18901;28278;6681;16469;83770
320240 Guarapari;0;0;0;0;0;0
320245 Ibatiba;38251;59416;68695;39618;53532;259512
320250 Ibiraçu;928;1074;0;0;0;2002
320255 Ibitirama;0;0;0;0;0;0
320260 Iconha;0;0;0;0;0;0
320265 Irupi;3654;11281;2079;5697;8520;31231
320270 Itaguaçu;0;0;0;0;0;0
320280 Itapemirim;248;84;0;0;444;776
320290 Itarana;0;0;0;0;0;0
320300 Iúna;43763;42647;75471;39389;26977;228247
320305 Jaguaré;106897;311468;387956;359401;622745;1788467
320310 Jerônimo Monteiro;664;87;1775;213;0;2739
320313 João Neiva;26158;33922;31609;12066;17070;120825
320316 Laranja da Terra;0;0;1601;2289;1026;4916
320320 Linhares;589;724;93;16;0;1422
320330 Mantenópolis;44138;66896;58638;22299;36387;228358
320332 Marataízes;0;0;0;0;0;0
320334 Marechal Floriano;5228;8136;12046;6523;11867;43800
320335 Marilândia;9542;12222;19682;893;0;42339
320340 Mimoso do Sul;18;2514;28;0;1859;4419
320350 Montanha;0;0;0;0;0;0
320360 Mucurici;74;0;0;0;0;74
320370 Muniz Freire;8;0;0;0;0;8
320380 Muqui;48;7220;13551;3209;4874;28902
320390 Nova Venécia;269;19;0;0;0;288
320400 Pancas;7028;49499;72411;49274;76596;254808
320405 Pedro Canário;10;41458;101413;55902;80110;278893
320410 Pinheiros;36205;113230;10686;2707;0;162828
320420 Piúma;0;0;0;24374;20559;44933
320425 Ponto Belo;12848;11533;27148;38574;55683;145786
320430 Presidente Kennedy;0;4163;21441;24463;35940;86007
320435 Rio Bananal;0;0;0;0;0;0
320440 Rio Novo do Sul;0;0;0;0;0;0
320450 Santa Leopoldina;0;0;17060;17722;40593;75375
320455 Santa Maria de Jetibá;384;0;0;7372;9732;17488
320460 Santa Teresa;13178;17984;5495;11540;17091;65288
320465 São Domingos do Norte;0;4760;16646;8764;13705;43875
320470 São Gabriel da Palha;61745;5320;78618;18002;43866;207551
320480 São José do Calçado;0;0;0;0;8455;8455
320490 São Mateus;103706;218033;175477;107470;115942;720628
320495 São Roque do Canaã;0;0;0;879;5361;6240
320500 Serra;2743;435;0;0;0;3178
320501 Sooretama;0;0;0;0;0;0
320503 Vargem Alta;4;68;8415;4417;6086;18990
320506 Venda Nova do Imigrante;37933;42331;52442;22991;25054;180751
320510 Viana;0;0;0;0;0;0
320515 Vila Pavão;0;0;0;0;0;0
320517 Vila Valério;2301;5;0;0;0;2306
320520 Vila Velha;0;0;1;0;0;1
320530 Vitória;705;714;0;0;0;1419
330010 Angra dos Reis;1132;335;1768;59424;102750;165409
330015 Aperibé;553;0;0;0;0;553
330020 Araruama;195;74;0;0;0;269
330022 Areal;0;0;0;0;0;0
330023 Armação dos Búzios;72;233;132;71;3;511
330025 Arraial do Cabo;0;0;0;0;0;0
330030 Barra do Piraí;0;67;0;0;0;67
330040 Barra Mansa;0;2043;205;248;51;2547
330045 Belford Roxo;1239;2640;2770;2904;7258;16811
330050 Bom Jardim;9;13;0;0;0;22
330060 Bom Jesus do Itabapoana;0;0;0;0;0;0
330070 Cabo Frio;283565;246427;284236;128071;67499;1009798
330080 Cachoeiras de Macacu;929;1607;2100;2264;49145;56045
330090 Cambuci;0;0;0;0;0;0
330100 Campos dos Goytacazes;22372;8397;0;0;0;30769
330110 Cantagalo;0;0;0;0;0;0
330093 Carapebus;0;0;0;0;0;0
330115 Cardoso Moreira;0;0;0;0;0;0
330120 Carmo;24;0;0;3586;13598;17208
330130 Casimiro de Abreu;0;0;86999;0;101682;188681
330095 Comendador Levy Gasparian;24;29;0;0;0;53
330140 Conceição de Macabu;0;0;0;0;0;0
330150 Cordeiro;57;15;0;0;0;72
330160 Duas Barras;8;21;0;0;0;29
330170 Duque de Caxias;152747;306793;399777;358136;428917;1646370
330180 Engenheiro Paulo de Frontin;0;3;0;2;186;191
330185 Guapimirim;42;127;0;0;0;169
330187 Iguaba Grande;34597;30744;12129;0;0;77470
330190 Itaboraí;51;0;0;2667;26824;29542
330200 Itaguaí;11116;8250;7626;16010;8599;51601
330205 Italva;0;0;0;0;0;0
330210 Itaocara;110;0;0;0;0;110
330220 Itaperuna;48617;40737;35233;13723;17228;155538
330225 Itatiaia;73;47;0;0;0;120
330227 Japeri;0;0;0;0;0;0
330230 Laje do Muriaé;0;0;0;0;0;0
330240 Macaé;156;0;0;0;2;158
330245 Macuco;0;0;0;0;0;0
330250 Magé;0;19725;15375;9532;18083;62715
330260 Mangaratiba;3582;4538;8590;10418;10442;37570
330270 Maricá;0;0;0;0;2087;2087
330280 Mendes;42;37;2;11;0;92
330285 Mesquita;0;0;0;0;0;0
330290 Miguel Pereira;0;0;0;0;0;0
330300 Miracema;183;181;105;184;0;653
330310 Natividade;21;17;0;0;0;38
330320 Nilópolis;0;0;0;0;0;0
330330 Niterói;528;420;143;80;0;1171
330340 Nova Friburgo;210;103;79;58;0;450
330350 Nova Iguaçu;499;403;0;0;0;902
330360 Paracambi;112;114;0;0;0;226
330370 Paraíba do Sul;559;0;0;0;0;559
330380 Paraty;35038;83826;113992;61453;112381;406690
330385 Paty do Alferes;0;0;0;0;0;0
330390 Petrópolis;972;1252;1139;2925;3493;9781
330395 Pinheiral;0;0;0;0;0;0
330400 Piraí;0;0;0;0;0;0
330410 Porciúncula;1761;84;99;61;0;2005
330411 Porto Real;23154;17328;27349;14512;31340;113683
330412 Quatis;13;0;0;0;0;13
330414 Queimados;8;24;0;0;0;32
330415 Quissamã;0;0;0;0;0;0
330420 Resende;106798;118596;117833;80901;103127;527255
330430 Rio Bonito;0;0;0;0;0;0
330440 Rio Claro;0;0;0;0;0;0
330450 Rio das Flores;0;0;0;0;0;0
330452 Rio das Ostras;58310;46205;139684;104856;179190;528245
330455 Rio de Janeiro;33409;30635;42123;65840;25179;197186
330460 Santa Maria Madalena;0;0;0;0;0;0
330470 Santo Antônio de Pádua;0;0;0;0;0;0
330480 São Fidélis;0;0;0;0;0;0
330475 São Francisco de Itabapoana;0;0;0;0;0;0
330490 São Gonçalo;1287;2673;2697;1498;3516;11671
330500 São João da Barra;11;94;575;251;278;1209
330510 São João de Meriti;0;0;0;0;0;0
330513 São José de Ubá;8425;5784;5196;838;0;20243
330515 São José do Vale do Rio Preto;0;0;0;0;0;0
330520 São Pedro da Aldeia;81564;75356;60955;41681;24952;284508
330530 São Sebastião do Alto;0;0;0;0;0;0
330540 Sapucaia;0;0;0;1;0;1
330550 Saquarema;280;123;48;35;0;486
330555 Seropédica;111;187;690;4676;8545;14209
330560 Silva Jardim;1328;1710;0;4082;8842;15962
330570 Sumidouro;0;0;0;0;0;0
330575 Tanguá;0;0;0;0;0;0
330580 Teresópolis;0;0;0;0;10561;10561
330590 Trajano de Moraes;0;0;0;0;0;0
330600 Três Rios;0;0;0;0;0;0
330610 Valença;207;207;217;101;0;732
330615 Varre-Sai;0;0;0;0;0;0
330620 Vassouras;47;221;0;0;0;268
330630 Volta Redonda;21457;31837;35789;19368;58711;167162
350010 Adamantina;119822;130008;136799;93276;111584;591489
350020 Adolfo;43;10;0;0;0;53
350030 Aguaí;135;57;0;0;0;192
350040 Águas da Prata;0;0;0;0;0;0
350050 Águas de Lindóia;60;71;0;0;0;131
350055 Águas de Santa Bárbara;0;0;0;0;0;0
350060 Águas de São Pedro;7;4;0;0;0;11
350070 Agudos;0;0;0;0;0;0
350075 Alambari;218;151;0;0;0;369
350080 Alfredo Marcondes;42;36;0;0;0;78
350090 Altair;11;2;0;0;0;13
350100 Altinópolis;52;108;0;0;0;160
350110 Alto Alegre;37;0;0;0;0;37
350115 Alumínio;104;92;0;0;0;196
350120 Álvares Florence;3730;4492;4283;3239;4832;20576
350130 Álvares Machado;84;101;0;0;0;185
350140 Álvaro de Carvalho;23;22;0;0;0;45
350150 Alvinlândia;0;0;0;0;0;0
350160 Americana;350;306;0;0;0;656
350170 Américo Brasiliense;244;142;0;0;0;386
350180 Américo de Campos;21;26;0;0;0;47
350190 Amparo;749;695;47;0;0;1491
350200 Analândia;11;18;16;0;0;45
350210 Andradina;61384;52949;43693;61036;91782;310844
350220 Angatuba;269;228;0;0;0;497
350230 Anhembi;82;51;0;0;0;133
350240 Anhumas;6;1;3965;2783;2945;9700
350250 Aparecida;0;0;0;0;0;0
350260 Aparecida d'Oeste;17;21;0;2603;3483;6124
350270 Apiaí;42;17;0;0;0;59
350275 Araçariguama;231;39;0;0;0;270
350280 Araçatuba;74153;43853;161114;94912;111471;485503
350290 Araçoiaba da Serra;112;85;0;0;0;197
350300 Aramina;29;0;2149;1306;17104;20588
350310 Arandu;0;0;0;0;0;0
350315 Arapeí;347;957;3091;728;6434;11557
350320 Araraquara;299;0;0;0;0;299
350330 Araras;737;680;105;40;0;1562
350335 Arco-Íris;7;1;0;0;0;8
350340 Arealva;16;24;0;0;200;240
350350 Areias;391;6267;5986;2953;3322;18919
350360 Areiópolis;0;0;155;510;765;1430
350370 Ariranha;21;22;0;0;0;43
350380 Artur Nogueira;420;333;0;0;0;753
350390 Arujá;1041;0;0;0;0;1041
350395 Aspásia;12;6;0;0;0;18
350400 Assis;491;375;0;0;0;866
350410 Atibaia;25537;28747;28337;26589;86949;196159
350420 Auriflama;9607;8709;11426;5770;47415;82927
350430 Avaí;5;14;0;0;0;19
350440 Avanhandava;113;10;0;5803;6052;11978
350450 Avaré;600;681;530;0;0;1811
350460 Bady Bassitt;95;134;0;0;0;229
350470 Balbinos;8;0;0;0;0;8
350480 Bálsamo;61;9;0;0;0;70
350490 Bananal;12494;16384;24424;13262;13120;79684
350500 Barão de Antonina;0;0;0;0;0;0
350510 Barbosa;12498;31013;28593;19741;18079;109924
350520 Bariri;0;0;0;0;26013;26013
350530 Barra Bonita;167;122;0;0;0;289
350535 Barra do Chapéu;12;2;0;0;0;14
350540 Barra do Turvo;28;8;0;0;0;36
350550 Barretos;1037;655;6;0;0;1698
350560 Barrinha;5289;9400;9666;5630;308;30293
350570 Barueri;4896;4298;1658;887;571;12310
350580 Bastos;193;215;0;0;1244;1652
350590 Batatais;415;322;0;0;0;737
350600 Bauru;17045;49411;36313;28886;40416;172071
350610 Bebedouro;518;226;5;0;0;749
350620 Bento de Abreu;18;2;0;0;0;20
350630 Bernardino de Campos;99;84;0;0;0;183
350635 Bertioga;420;363;0;0;0;783
350640 Bilac;59;0;21338;22163;24006;67566
350650 Birigui;237;0;0;0;0;237
350660 Biritiba-Mirim;323;316;89;0;26;754
350670 Boa Esperança do Sul;0;0;0;0;0;0
350680 Bocaina;0;0;900;15900;19587;36387
350690 Bofete;60;28;0;0;0;88
350700 Boituva;658;5130;14471;19190;29270;68719
350710 Bom Jesus dos Perdões;189;168;0;0;0;357
350715 Bom Sucesso de Itararé;0;0;0;0;0;0
350720 Borá;0;0;0;0;1;1
350730 Boracéia;0;499;1;0;0;500
350740 Borborema;80;41;0;0;0;121
350745 Borebi;5;3;0;0;195;203
350750 Botucatu;675;0;0;0;0;675
350760 Bragança Paulista;518;0;0;0;0;518
350770 Braúna;0;0;0;0;0;0
350775 Brejo Alegre;8;0;0;0;0;8
350780 Brodowski;0;0;0;0;0;0
350790 Brotas;244;44;0;0;0;288
350800 Buri;23522;27432;28541;19096;16214;114805
350810 Buritama;22882;28031;17369;31758;33097;133137
350820 Buritizal;17;0;0;0;0;17
350830 Cabrália Paulista;10777;9357;9383;2782;3308;35607
350840 Cabreúva;0;0;0;0;0;0
350850 Caçapava;54574;50315;52635;39104;23088;219716
350860 Cachoeira Paulista;0;0;0;0;0;0
350870 Caconde;39;0;0;1881;7379;9299
350880 Cafelândia;0;0;0;0;0;0
350890 Caiabu;0;0;0;0;0;0
350900 Caieiras;0;0;0;0;0;0
350910 Caiuá;0;0;0;0;0;0
350920 Cajamar;562;104;0;0;0;666
350925 Cajati;243;8;1394;275;1556;3476
350930 Cajobi;0;0;0;0;0;0
350940 Cajuru;95;98;0;0;0;193
350945 Campina do Monte Alegre;0;0;0;0;0;0
350950 Campinas;8172;388;0;0;0;8560
350960 Campo Limpo Paulista;0;0;0;0;0;0
350970 Campos do Jordão;0;0;0;0;0;0
350980 Campos Novos Paulista;24;6;223;172;251;676
350990 Cananéia;141;100;0;0;0;241
350995 Canas;0;0;10793;8735;5239;24767
351000 Cândido Mota;223;142;0;0;0;365
351010 Cândido Rodrigues;0;0;0;0;0;0
351015 Canitar;11;4;0;0;0;15
351020 Capão Bonito;487;221;73;16;0;797
351030 Capela do Alto;155;122;0;0;0;277
351040 Capivari;433;273;0;0;0;706
351050 Caraguatatuba;1214;1134;1029;797;0;4174
351060 Carapicuíba;1745;1733;0;0;0;3478
351070 Cardoso;237;543;30;0;0;810
351080 Casa Branca;111;167;0;0;0;278
351090 Cássia dos Coqueiros;0;0;0;0;0;0
351100 Castilho;8401;11136;8064;9589;5579;42769
351110 Catanduva;49973;43429;60753;8617;38500;201272
351120 Catiguá;9;3;0;0;0;12
351130 Cedral;27;52;0;0;0;79
351140 Cerqueira César;127;128;0;0;0;255
351150 Cerquilho;221;4083;5150;6478;3605;19537
351160 Cesário Lange;156;78;0;0;0;234
351170 Charqueada;21;0;0;400;5363;5784
355720 Chavantes;147;122;0;0;0;269
351190 Clementina;0;0;0;0;0;0
351200 Colina;271;76;0;0;0;347
351210 Colômbia;18;35;6;0;0;59
351220 Conchal;293;271;10836;18704;22569;52673
351230 Conchas;10;0;0;0;0;10
351240 Cordeirópolis;102;59;0;0;0;161
351250 Coroados;0;0;0;0;0;0
351260 Coronel Macedo;0;0;0;0;0;0
351270 Corumbataí;53;35;0;4526;10754;15368
351280 Cosmópolis;0;0;966;17720;36233;54919
351290 Cosmorama;0;0;0;0;0;0
351300 Cotia;1267;0;0;0;0;1267
351310 Cravinhos;0;0;0;0;0;0
351320 Cristais Paulista;79;0;0;0;0;79
351330 Cruzália;8928;10788;10657;8481;7888;46742
351340 Cruzeiro;0;57;121310;99760;104756;325883
351350 Cubatão;650;641;38;0;0;1329
351360 Cunha;81;31;0;0;0;112
351370 Descalvado;6604;7186;9808;26456;26022;76076
351380 Diadema;3918;1655;0;0;0;5573
351385 Dirce Reis;0;0;0;0;0;0
351390 Divinolândia;22;2;0;0;0;24
351400 Dobrada;0;0;138;2530;0;2668
351410 Dois Córregos;193;94;0;2;0;289
351420 Dolcinópolis;1;0;0;0;0;1
351430 Dourado;0;0;0;0;0;0
351440 Dracena;85442;102033;107145;69409;65257;429286
351450 Duartina;30;4;0;0;0;34
351460 Dumont;103;73;49;15;2;242
351470 Echaporã;58;24;0;0;0;82
351480 Eldorado;18;15;0;0;0;33
351490 Elias Fausto;5493;5036;1941;2419;22692;37581
351492 Elisiário;1071;581;1249;692;3685;7278
351495 Embaúba;0;0;0;0;0;0
351500 Embu das Artes;3678;315;2988;8080;5498;20559
351510 Embu-Guaçu;682;619;0;0;0;1301
351512 Emilianópolis;15;12;0;0;0;27
351515 Engenheiro Coelho;230;183;0;0;0;413
351518 Espírito Santo do Pinhal;212;173;0;0;0;385
351519 Espírito Santo do Turvo;29;34;0;0;0;63
355730 Estiva Gerbi;0;0;0;0;0;0
351520 Estrela d'Oeste;65;68;0;0;0;133
351530 Estrela do Norte;0;0;0;0;0;0
351535 Euclides da Cunha Paulista;8;16;3741;17748;12569;34082
351540 Fartura;165;154;0;0;0;319
351560 Fernando Prestes;7260;13029;16658;11030;2188;50165
351550 Fernandópolis;44448;51207;58552;33117;36416;223740
351565 Fernão;10;3;2679;3079;0;5771
351570 Ferraz de Vasconcelos;1798;1723;1400;1313;1309;7543
351580 Flora Rica;5;3;0;100;2885;2993
351590 Floreal;0;0;10802;11201;11302;33305
351600 Flórida Paulista;55;10;0;0;0;65
351610 Florínia;13;1369;3875;3978;3805;13040
351620 Franca;201026;206652;145460;71145;90105;714388
351630 Francisco Morato;2056;1170;624;0;0;3850
351640 Franco da Rocha;1346;1093;35;0;0;2474
351650 Gabriel Monteiro;18;0;0;0;0;18
351660 Gália;45;25;0;0;0;70
351670 Garça;204;111;0;0;0;315
351680 Gastão Vidigal;0;0;0;6778;1450;8228
351685 Gavião Peixoto;0;0;0;0;0;0
351690 General Salgado;10;8;0;0;0;18
351700 Getulina;70;19;0;0;0;89
351710 Glicério;13;1803;12375;4858;8499;27548
351720 Guaiçara;120;59;0;0;0;179
351730 Guaimbê;31;28;0;0;0;59
351740 Guaíra;36058;41514;35228;24510;28514;165824
351750 Guapiaçu;2139;2190;2598;1467;1771;10165
351760 Guapiara;0;0;0;0;0;0
351770 Guará;64;39;0;0;0;103
351780 Guaraçaí;65;23;0;0;0;88
351790 Guaraci;56;31;0;0;0;87
351800 Guarani d'Oeste;20;9;10446;23791;27159;61425
351810 Guarantã;53;26;0;0;0;79
351820 Guararapes;0;0;0;0;1667;1667
351830 Guararema;441;390;318;22;0;1171
351840 Guaratinguetá;10846;45933;47515;42251;50493;197038
351850 Guareí;174;100;0;0;0;274
351860 Guariba;254;38516;22201;7736;16687;85394
351870 Guarujá;2266;2847;113;117;0;5343
351880 Guarulhos;3570;6037;3893;2651;2312;18463
351885 Guatapará;0;0;7179;3418;2602;13199
351890 Guzolândia;2;6;0;0;0;8
351900 Herculândia;53;39;0;0;0;92
351905 Holambra;0;0;0;0;0;0
351907 Hortolândia;26422;2425;1137;606;228;30818
351910 Iacanga;78;74;0;0;0;152
351920 Iacri;20;22;0;0;0;42
351925 Iaras;0;0;0;0;0;0
351930 Ibaté;0;0;0;0;0;0
351940 Ibirá;86;0;0;0;0;86
351950 Ibirarema;6781;15579;13848;10041;10113;56362
351960 Ibitinga;0;1947;6190;27765;7582;43484
351970 Ibiúna;0;62;0;0;0;62
351980 Icém;3779;7506;8960;6444;8288;34977
351990 Iepê;144;99;0;0;0;243
352000 Igaraçu do Tietê;207;110;0;0;11510;11827
352010 Igarapava;186;198;200;0;0;584
352020 Igaratá;5265;8713;4860;10268;11076;40182
352030 Iguape;225;15;0;0;0;240
352042 Ilha Comprida;147;105;0;0;0;252
352044 Ilha Solteira;77423;113763;135412;87218;92439;506255
352040 Ilhabela;328;164;0;37777;40758;79027
352050 Indaiatuba;2943;2358;86;152;0;5539
352060 Indiana;43;50;0;0;0;93
352070 Indiaporã;24;27;6398;15291;14733;36473
352080 Inúbia Paulista;1;0;0;0;0;1
352090 Ipaussu;1639;24;2014;5513;6561;15751
352100 Iperó;160;175;0;0;0;335
352110 Ipeúna;0;17;0;0;1356;1373
352115 Ipiguá;0;0;0;0;0;0
352120 Iporanga;0;0;0;0;0;0
352130 Ipuã;13436;13465;14644;3349;0;44894
352140 Iracemápolis;0;0;0;0;0;0
352150 Irapuã;44517;43758;47288;36980;34155;206698
352160 Irapuru;27;13;0;0;0;40
352170 Itaberá;172;106;0;0;0;278
352180 Itaí;91;109;0;0;22;222
352190 Itajobi;26987;16856;12119;11910;16492;84364
352200 Itaju;0;0;0;0;0;0
352210 Itanhaém;44802;61897;41880;55414;68420;272413
352215 Itaóca;0;0;0;0;0;0
352220 Itapecerica da Serra;2684;0;0;0;0;2684
352230 Itapetininga;1326;930;0;0;0;2256
352240 Itapeva;67;0;0;0;0;67
352250 Itapevi;1291;86;0;0;0;1377
352260 Itapira;35715;27677;45099;43131;57860;209482
352265 Itapirapuã Paulista;22;14;0;0;0;36
352270 Itápolis;312;240;42941;24652;24238;92383
352280 Itaporanga;89;128;0;0;0;217
352290 Itapuí;0;0;9878;21484;18107;49469
352300 Itapura;0;0;8402;25321;23924;57647
352310 Itaquaquecetuba;1850;930;0;0;0;2780
352320 Itararé;312;60;18;3;0;393
352330 Itariri;172;126;68;0;0;366
352340 Itatiba;752;570;14;25;6750;8111
352350 Itatinga;0;0;0;0;13310;13310
352360 Itirapina;1066;6569;13382;7252;8853;37122
352370 Itirapuã;1;1;1126;3733;3624;8485
352380 Itobi;0;0;0;0;0;0
352390 Itu;10759;21140;29777;43945;54481;160102
352400 Itupeva;352;299;0;0;0;651
352410 Ituverava;259;303;303;277;253;1395
352420 Jaborandi;1703;1270;1212;790;4409;9384
352430 Jaboticabal;393;341;83;0;0;817
352440 Jacareí;1756;1481;0;0;0;3237
352450 Jaci;59;48;0;0;0;107
352460 Jacupiranga;142;141;0;0;0;283
352470 Jaguariúna;653;674;0;0;0;1327
352480 Jales;9421;2607;2275;6659;23578;44540
352490 Jambeiro;35;16;0;0;0;51
352500 Jandira;768;566;65;0;0;1399
352510 Jardinópolis;0;0;0;0;0;0
352520 Jarinu;130;0;0;0;0;130
352530 Jaú;1325;835;33;58;0;2251
352540 Jeriquara;4;0;0;0;0;4
352550 Joanópolis;76;90;0;0;0;166
352560 João Ramalho;0;0;0;0;0;0
352570 José Bonifácio;142;146;0;0;0;288
352580 Júlio Mesquita;29;9;0;0;0;38
352585 Jumirim;159;2279;6294;6484;4795;20011
352590 Jundiaí;2283;1653;0;0;0;3936
352600 Junqueirópolis;1512;81;0;0;0;1593
352610 Juquiá;156;78;0;0;0;234
352620 Juquitiba;96;0;0;0;0;96
352630 Lagoinha;0;0;0;0;0;0
352640 Laranjal Paulista;169;599;610;908;1387;3673
352650 Lavínia;15;19866;27448;24597;0;71926
352660 Lavrinhas;0;0;0;58;9281;9339
352670 Leme;8820;4526;3;0;0;13349
352680 Lençóis Paulista;551;352;0;0;0;903
352690 Limeira;1619;1213;0;0;0;2832
352700 Lindóia;0;0;0;0;0;0
352710 Lins;487;0;0;0;0;487
352720 Lorena;224;184;27;83;11;529
352725 Lourdes;0;0;0;0;0;0
352730 Louveira;67;0;0;0;0;67
352740 Lucélia;47704;46250;70428;40238;36758;241378
352750 Lucianópolis;0;0;0;0;0;0
352760 Luís Antônio;0;0;0;0;0;0
352770 Luiziânia;51;25;0;0;0;76
352780 Lupércio;12;0;0;0;0;12
352790 Lutécia;8;1;0;0;0;9
352800 Macatuba;0;0;0;0;0;0
352810 Macaubal;27;31;0;0;0;58
352820 Macedônia;17;8;0;0;0;25
352830 Magda;5;4;0;0;0;9
352840 Mairinque;307;316;0;0;0;623
352850 Mairiporã;738;0;0;0;0;738
352860 Manduri;32;41;0;0;0;73
352870 Marabá Paulista;0;0;0;0;0;0
352880 Maracaí;109;55;0;0;0;164
352885 Marapoama;4063;3581;2772;2367;2127;14910
352890 Mariápolis;581;662;65;0;0;1308
352900 Marília;1454;286;0;0;0;1740
352910 Marinópolis;8;2;0;0;15;25
352920 Martinópolis;194;113;0;0;0;307
352930 Matão;355;268;0;0;0;623
352940 Mauá;4250;3157;3275;1913;186;12781
352950 Mendonça;13493;10818;8514;6643;4206;43674
352960 Meridiano;40;0;0;0;0;40
352965 Mesópolis;0;0;0;0;0;0
352970 Miguelópolis;0;0;0;0;0;0
352980 Mineiros do Tietê;63;0;0;0;0;63
353000 Mira Estrela;23;5;0;0;0;28
352990 Miracatu;3437;58;0;0;0;3495
353010 Mirandópolis;144;54;0;0;0;198
353020 Mirante do Paranapanema;4;20473;46161;10285;28927;105850
353030 Mirassol;3698;3875;2867;1180;90;11710
353040 Mirassolândia;57;18;0;0;0;75
353050 Mococa;0;0;5343;24063;10098;39504
353060 Mogi das Cruzes;0;0;0;0;0;0
353070 Mogi Guaçu;909;613;0;0;0;1522
353080 Moji Mirim;444;175;0;0;0;619
353090 Mombuca;23;12;0;0;0;35
353100 Monções;4843;5415;6479;1740;6916;25393
353110 Mongaguá;57848;57833;66473;59627;72618;314399
353120 Monte Alegre do Sul;0;0;0;0;0;0
353130 Monte Alto;224;0;0;0;0;224
353140 Monte Aprazível;16;22;0;0;0;38
353150 Monte Azul Paulista;88;52;0;0;0;140
353160 Monte Castelo;18;22;0;0;0;40
353180 Monte Mor;712;24;0;0;0;736
353170 Monteiro Lobato;0;0;0;0;0;0
353190 Morro Agudo;156;230;0;0;0;386
353200 Morungaba;88;93;0;0;0;181
353205 Motuca;0;0;0;0;0;0
353210 Murutinga do Sul;11845;12191;17928;9212;13154;64330
353215 Nantes;15;22;0;0;0;37
353220 Narandiba;11;635;7322;3168;5118;16254
353230 Natividade da Serra;0;0;0;0;0;0
353240 Nazaré Paulista;0;0;0;0;0;0
353250 Neves Paulista;12378;17287;10141;8169;10613;58588
353260 Nhandeara;27574;33388;3882;0;4328;69172
353270 Nipoã;6;5411;17128;16781;9320;48646
353280 Nova Aliança;416;0;712;1113;1263;3504
353282 Nova Campina;0;0;0;0;0;0
353284 Nova Canaã Paulista;4;1740;10852;8591;11483;32670
353286 Nova Castilho;0;0;0;8044;14174;22218
353290 Nova Europa;0;9;0;0;0;9
353300 Nova Granada;60;24;0;0;0;84
353310 Nova Guataporanga;1860;9;11;0;11559;13439
353320 Nova Independência;0;0;0;0;0;0
353330 Nova Luzitânia;3936;133747;165126;66742;0;369551
353340 Nova Odessa;345;134;0;375;0;854
353325 Novais;15;171;1479;397;1459;3521
353350 Novo Horizonte;43545;37412;50001;32261;31306;194525
353360 Nuporanga;0;0;0;0;0;0
353370 Ocauçu;6;0;0;0;0;6
353380 Óleo;21;21;0;0;0;42
353390 Olímpia;46587;61250;58634;50449;47605;264525
353400 Onda Verde;6;3;0;0;0;9
353410 Oriente;33;1;0;0;0;34
353420 Orindiúva;0;0;0;0;0;0
353430 Orlândia;242;238;0;0;0;480
353440 Osasco;5100;5385;5283;4497;1876;22141
353450 Oscar Bressane;50;21;0;0;0;71
353460 Osvaldo Cruz;85154;84847;80345;44027;64330;358703
353470 Ourinhos;705;704;18;0;0;1427
353480 Ouro Verde;13221;29156;34434;23117;19694;119622
353475 Ouroeste;2;43;0;0;0;45
353490 Pacaembu;47;39;0;0;0;86
353500 Palestina;50;28;0;0;1510;1588
353510 Palmares Paulista;1139;1192;3500;4412;3815;14058
353520 Palmeira d'Oeste;37;43;0;0;0;80
353530 Palmital;44452;49397;48744;30995;28671;202259
353540 Panorama;21983;66118;53436;51448;49907;242892
353550 Paraguaçu Paulista;357;57;0;0;0;414
353560 Paraibuna;153;100;0;0;0;253
353570 Paraíso;11556;7696;13197;7515;4673;44637
353580 Paranapanema;169;0;0;0;0;169
353590 Paranapuã;0;0;0;0;1415;1415
353600 Parapuã;81;0;0;0;0;81
353610 Pardinho;89;76;0;0;0;165
353620 Pariquera-Açu;226;33;0;0;0;259
353625 Parisi;23;7;0;2506;6060;8596
353630 Patrocínio Paulista;6;23;25;79;0;133
353640 Paulicéia;4213;6147;7142;23778;17830;59110
353650 Paulínia;857;1078;0;229;0;2164
353657 Paulistânia;18;23;0;0;0;41
353660 Paulo de Faria;8;12;0;0;0;20
353670 Pederneiras;413;326;0;0;0;739
353680 Pedra Bela;50;0;0;0;0;50
353690 Pedranópolis;9;0;0;0;0;9
353700 Pedregulho;0;0;0;0;0;0
353710 Pedreira;312;295;0;0;0;607
353715 Pedrinhas Paulista;14237;13016;12590;8383;7958;56184
353720 Pedro de Toledo;0;0;0;0;0;0
353730 Penápolis;287;293;0;0;76241;76821
353740 Pereira Barreto;0;0;0;0;0;0
353750 Pereiras;0;0;0;0;0;0
353760 Peruíbe;601;59;0;0;0;660
353770 Piacatu;42;2650;3660;3023;4200;13575
353780 Piedade;0;0;0;0;0;0
353790 Pilar do Sul;278;255;0;0;0;533
353800 Pindamonhangaba;1316;1667;0;0;0;2983
353810 Pindorama;8146;7966;6590;3502;3469;29673
353820 Pinhalzinho;0;0;0;0;0;0
353830 Piquerobi;1507;3607;1921;3489;4569;15093
353850 Piquete;5;8851;20823;17517;33264;80460
353860 Piracaia;25;0;0;0;0;25
353870 Piracicaba;3695;2344;0;0;0;6039
353880 Piraju;0;0;0;0;0;0
353890 Pirajuí;79;0;0;0;0;79
353900 Pirangi;43;39;0;0;6347;6429
353910 Pirapora do Bom Jesus;59;65;0;0;0;124
353920 Pirapozinho;69;2037;16767;13567;12158;44598
353930 Pirassununga;257;181;0;12923;21896;35257
353940 Piratininga;134;10;0;0;0;144
353950 Pitangueiras;309;201;0;0;0;510
353960 Planalto;36;10;12874;16735;14271;43926
353970 Platina;313;358;280;0;360;1311
353980 Poá;1000;640;171;88;0;1899
353990 Poloni;9647;16322;30439;20415;18582;95405
354000 Pompéia;8228;8543;5809;10262;11025;43867
354010 Pongaí;15;4;0;0;0;19
354020 Pontal;15074;17194;13635;9971;12339;68213
354025 Pontalinda;0;1;0;0;0;1
354030 Pontes Gestal;0;0;0;0;0;0
354040 Populina;3;0;0;0;0;3
354050 Porangaba;0;0;0;0;0;0
354060 Porto Feliz;409;356;0;0;0;765
354070 Porto Ferreira;3834;192;29705;43685;37281;114697
354075 Potim;0;10702;7501;6076;8536;32815
354080 Potirendaba;72;41;0;0;0;113
354085 Pracinha;8585;9642;10962;7879;5586;42654
354090 Pradópolis;7535;8485;6576;4322;3189;30107
354100 Praia Grande;14898;29805;46252;31416;37295;159666
354105 Pratânia;48;44;0;0;0;92
354110 Presidente Alves;36;0;0;0;0;36
354120 Presidente Bernardes;0;14;0;0;0;14
354130 Presidente Epitácio;6521;20602;0;0;0;27123
354140 Presidente Prudente;136832;132774;120358;76735;84443;551142
354150 Presidente Venceslau;44457;46970;40771;66558;65960;264716
354160 Promissão;263;135;0;0;0;398
354165 Quadra;51;47;0;0;0;98
354170 Quatá;128;74;0;0;0;202
354180 Queiroz;39;19;0;0;0;58
354190 Queluz;0;0;0;0;0;0
354200 Quintana;1705;1388;1497;1087;3191;8868
354210 Rafard;30960;23418;28124;20734;23031;126267
354220 Rancharia;488;255;292;69;20;1124
354230 Redenção da Serra;49;31;0;0;0;80
354240 Regente Feijó;139;116;0;0;0;255
354250 Reginópolis;62;26;0;0;0;88
354260 Registro;797;4;0;0;0;801
354270 Restinga;7;0;0;0;0;7
354280 Ribeira;0;0;0;0;0;0
354290 Ribeirão Bonito;2209;5105;4927;3520;4994;20755
354300 Ribeirão Branco;0;0;0;0;0;0
354310 Ribeirão Corrente;10;0;0;0;0;10
354320 Ribeirão do Sul;20;19;1614;809;0;2462
354323 Ribeirão dos Índios;1;5;0;0;0;6
354325 Ribeirão Grande;29;1;0;0;0;30
354330 Ribeirão Pires;620;503;0;0;0;1123
354340 Ribeirão Preto;4666;0;0;0;0;4666
354360 Rifaina;16;0;0;0;0;16
354370 Rincão;0;0;0;0;0;0
354380 Rinópolis;32;19;0;0;0;51
354390 Rio Claro;1120;1136;172;0;0;2428
354400 Rio das Pedras;257;1107;1621;4028;6196;13209
354410 Rio Grande da Serra;150;171;0;0;0;321
354420 Riolândia;41;40;0;0;294;375
354350 Riversul;0;0;0;0;0;0
354425 Rosana;65;0;0;0;0;65
354430 Roseira;1170;1967;1687;333;2321;7478
354440 Rubiácea;13;0;0;0;0;13
354450 Rubinéia;1113;571;25;0;0;1709
354460 Sabino;2;2;0;0;0;4
354470 Sagres;15;3;0;0;0;18
354480 Sales;10428;11485;7912;8957;15003;53785
354490 Sales Oliveira;0;0;13901;16092;7139;37132
354500 Salesópolis;0;0;0;0;0;0
354510 Salmourão;45;55;0;0;0;100
354515 Saltinho;2;780;3929;4154;5504;14369
354520 Salto;984;531;34047;17398;7640;60600
354530 Salto de Pirapora;365;313;0;0;1500;2178
354540 Salto Grande;88;29;0;0;1500;1617
354550 Sandovalina;7;11;0;0;0;18
354560 Santa Adélia;27599;31553;32588;19771;20019;131530
354570 Santa Albertina;27;30;0;0;0;57
354580 Santa Bárbara d'Oeste;4482;5446;11437;6957;5690;34012
354600 Santa Branca;0;0;0;0;0;0
354610 Santa Clara d'Oeste;14;18;0;1014;1898;2944
354620 Santa Cruz da Conceição;20;17;0;0;8558;8595
354625 Santa Cruz da Esperança;3;0;0;0;0;3
354630 Santa Cruz das Palmeiras;427;328;0;0;0;755
354640 Santa Cruz do Rio Pardo;2475;11671;26039;14320;12620;67125
354650 Santa Ernestina;12;0;0;0;0;12
354660 Santa Fé do Sul;171837;180562;137758;0;58473;548630
354670 Santa Gertrudes;0;0;0;0;0;0
354680 Santa Isabel;647;36;0;0;0;683
354690 Santa Lúcia;0;0;0;0;0;0
354700 Santa Maria da Serra;38;38;0;0;0;76
354710 Santa Mercedes;15509;11019;21874;15510;13196;77108
354740 Santa Rita d'Oeste;1461;95;509;2146;2419;6630
354750 Santa Rita do Passa Quatro;0;0;0;0;0;0
354760 Santa Rosa de Viterbo;206;79;0;0;0;285
354765 Santa Salete;0;5;0;0;0;5
354720 Santana da Ponte Pensa;0;0;0;0;3178;3178
354730 Santana de Parnaíba;1450;1195;666;581;50;3942
354770 Santo Anastácio;119;60;0;0;0;179
354780 Santo André;3015;1027;90;93;18;4243
354790 Santo Antônio da Alegria;46;41;0;0;0;87
354800 Santo Antônio de Posse;36;0;0;246;30794;31076
354805 Santo Antônio do Aracanguá;0;0;0;0;0;0
354810 Santo Antônio do Jardim;55;46;0;0;0;101
354820 Santo Antônio do Pinhal;0;0;0;0;0;0
354830 Santo Expedito;168;85;57;72;42;424
354840 Santópolis do Aguapeí;0;0;253;16061;18302;34616
354850 Santos;31171;22474;27101;1261;6873;88880
354860 São Bento do Sapucaí;38;9;0;0;0;47
354870 São Bernardo do Campo;7526;6302;4608;2316;4863;25615
354880 São Caetano do Sul;1181;408;0;0;0;1589
354890 São Carlos;56111;58694;41508;0;0;156313
354900 São Francisco;7;6;0;0;0;13
354910 São João da Boa Vista;566;597;81;58;0;1302
354920 São João das Duas Pontes;0;0;0;0;0;0
354925 São João de Iracema;0;1516;9736;8570;0;19822
354930 São João do Pau d'Alho;9;7;0;0;0;16
354940 São Joaquim da Barra;0;0;0;0;0;0
354950 São José da Bela Vista;13;79;33;0;0;125
354960 São José do Barreiro;8865;7546;0;0;8161;24572
354970 São José do Rio Pardo;409;231;0;0;0;640
354980 São José do Rio Preto;20058;17762;20179;15145;12165;85309
354990 São José dos Campos;89192;100681;70263;27937;36689;324762
354995 São Lourenço da Serra;267;0;0;0;0;267
355000 São Luís do Paraitinga;6;0;0;0;0;6
355010 São Manuel;331;210;0;0;0;541
355020 São Miguel Arcanjo;266;100;0;0;0;366
355030 São Paulo;166495;135027;132101;130367;136995;700985
355040 São Pedro;33879;54247;33170;19623;21882;162801
355050 São Pedro do Turvo;62;15;2960;4729;1033;8799
355060 São Roque;938;909;90;161;0;2098
355070 São Sebastião;581;284;0;0;0;865
355080 São Sebastião da Grama;83;29;0;0;0;112
355090 São Simão;58;54;0;0;0;112
355100 São Vicente;41128;55407;73228;39927;40009;249699
355110 Sarapuí;152;76;0;0;6;234
355120 Sarutaiá;0;0;0;0;0;0
355130 Sebastianópolis do Sul;16;0;0;0;0;16
355140 Serra Azul;21;0;0;0;0;21
355160 Serra Negra;0;0;0;0;0;0
355150 Serrana;415;355;0;0;0;770
355170 Sertãozinho;507;302;0;0;0;809
355180 Sete Barras;179;114;0;0;0;293
355190 Severínia;0;0;0;0;0;0
355200 Silveiras;0;0;0;0;0;0
355210 Socorro;0;0;0;0;0;0
355220 Sorocaba;26226;16890;12377;18478;11248;85219
355230 Sud Mennucci;49581;37474;46427;27682;26199;187363
355240 Sumaré;2798;3120;319;0;0;6237
355255 Suzanápolis;2059;2233;1800;1363;1101;8556
355250 Suzano;5537;6172;6798;2249;3668;24424
355260 Tabapuã;3655;4118;3053;1478;2658;14962
355270 Tabatinga;59;79;0;0;0;138
355280 Taboão da Serra;0;0;0;0;0;0
355290 Taciba;600;7904;7964;6656;4884;28008
355300 Taguaí;65190;68987;86918;53268;68649;343012
355310 Taiaçu;6734;13375;10486;5597;0;36192
355320 Taiúva;29;594;0;2;0;625
355330 Tambaú;267;196;0;0;150;613
355340 Tanabi;92;56;0;0;0;148
355350 Tapiraí;53;62;0;0;0;115
355360 Tapiratiba;83;49;0;0;0;132
355365 Taquaral;17;5;0;0;0;22
355370 Taquaritinga;414;247;0;0;0;661
355380 Taquarituba;51870;43869;51301;45585;54728;247353
355385 Taquarivaí;49;0;0;0;0;49
355390 Tarabai;10;25;0;0;0;35
355395 Tarumã;157;111;0;0;0;268
355400 Tatuí;662;506;24000;66400;48000;139568
355410 Taubaté;2323;1577;0;0;0;3900
355420 Tejupá;0;0;0;0;0;0
355430 Teodoro Sampaio;5913;219;9761;22993;3490;42376
355440 Terra Roxa;65;35;0;0;0;100
355450 Tietê;310;125;0;0;0;435
355460 Timburi;22;0;0;0;0;22
355465 Torre de Pedra;0;0;0;0;0;0
355470 Torrinha;0;0;5286;0;19354;24640
355475 Trabiju;4;0;0;0;0;4
355480 Tremembé;116;95;0;0;0;211
355490 Três Fronteiras;3;0;0;0;0;3
355495 Tuiuti;54;35;0;0;0;89
355500 Tupã;371;5850;10192;5986;10407;32806
355510 Tupi Paulista;55;46;0;2375;3350;5826
355520 Turiúba;3;3;51713;35311;101327;188357
355530 Turmalina;0;0;0;0;0;0
355535 Ubarana;2138;943;32;235;0;3348
355540 Ubatuba;81285;92595;103842;81461;93103;452286
355550 Ubirajara;5956;6579;6794;3827;4747;27903
355560 Uchoa;5;23;1080;2760;1900;5768
355570 União Paulista;3225;7418;1795;1475;0;13913
355580 Urânia;53;1529;3704;2785;2829;10900
355590 Uru;9;0;0;0;0;9
355600 Urupês;1848;7598;7769;6052;8988;32255
355610 Valentim Gentil;89;0;0;0;0;89
355620 Valinhos;723;574;300;28;50;1675
355630 Valparaíso;130;89;134;1;0;354
355635 Vargem;0;0;0;0;0;0
355640 Vargem Grande do Sul;382;195;0;0;0;577
355645 Vargem Grande Paulista;698;543;0;0;0;1241
355650 Várzea Paulista;596;454;80;0;0;1130
355660 Vera Cruz;81;1246;1134;2253;3267;7981
355670 Vinhedo;592;486;0;0;0;1078
355680 Viradouro;126;53;0;0;0;179
355690 Vista Alegre do Alto;5152;0;0;0;0;5152
355695 Vitória Brasil;6;10;0;0;0;16
355700 Votorantim;1215;786;0;0;0;2001
355710 Votuporanga;122621;142869;141262;89523;93927;590202
355715 Zacarias;22180;27341;26278;20288;15265;111352
410010 Abatiá;0;0;0;0;0;0
410020 Adrianópolis;78;50;0;0;0;128
410030 Agudos do Sul;0;0;0;0;0;0
410040 Almirante Tamandaré;890;711;0;0;0;1601
410045 Altamira do Paraná;0;0;0;0;0;0
412862 Alto Paraíso;0;0;0;0;0;0
410060 Alto Paraná;0;0;0;0;0;0
410070 Alto Piquiri;101;76;772;1934;296;3179
410050 Altônia;33309;41230;51933;31605;24043;182120
410080 Alvorada do Sul;138;94;0;0;0;232
410090 Amaporã;0;0;0;0;0;0
410100 Ampére;317;567;1309;0;65;2258
410105 Anahy;32;4;0;0;0;36
410110 Andirá;49;29;0;0;0;78
410115 Ângulo;0;0;0;0;0;0
410120 Antonina;0;0;0;0;0;0
410130 Antônio Olinto;33;39;0;0;0;72
410140 Apucarana;0;0;0;0;0;0
410150 Arapongas;117;0;5;0;0;122
410160 Arapoti;174;93;0;0;0;267
410165 Arapuã;88;30;0;0;0;118
410170 Araruna;108;62;0;0;0;170
410180 Araucária;16877;17805;16901;16939;11356;79878
410185 Ariranha do Ivaí;13;8;0;0;0;21
410190 Assaí;0;0;0;0;0;0
410200 Assis Chateaubriand;128;119;0;0;0;247
410210 Astorga;442;192;0;0;0;634
410220 Atalaia;16;0;0;0;0;16
410230 Balsa Nova;56;48;0;0;0;104
410240 Bandeirantes;301;160;0;0;0;461
410250 Barbosa Ferraz;51;14;0;0;0;65
410270 Barra do Jacaré;24;0;0;0;0;24
410260 Barracão;66;1838;17977;13170;15815;48866
410275 Bela Vista da Caroba;0;0;0;0;0;0
410280 Bela Vista do Paraíso;55;82;0;0;0;137
410290 Bituruna;0;0;0;0;0;0
410300 Boa Esperança;20;14;0;0;0;34
410302 Boa Esperança do Iguaçu;0;0;0;0;0;0
410304 Boa Ventura de São Roque;11;2;0;0;0;13
410305 Boa Vista da Aparecida;1169;11981;29585;9582;163;52480
410310 Bocaiúva do Sul;66;0;0;0;0;66
410315 Bom Jesus do Sul;3;0;0;0;0;3
410320 Bom Sucesso;0;0;0;0;0;0
410322 Bom Sucesso do Sul;0;0;0;0;0;0
410330 Borrazópolis;0;0;0;0;0;0
410335 Braganey;27;0;0;0;0;27
410337 Brasilândia do Sul;26;25;0;0;0;51
410340 Cafeara;2;0;0;0;0;2
410345 Cafelândia;138;173;0;0;0;311
410347 Cafezal do Sul;38;28;0;0;0;66
410350 Califórnia;0;0;0;0;0;0
410360 Cambará;14;4;0;0;0;18
410370 Cambé;521;364;0;0;0;885
410380 Cambira;0;0;0;0;0;0
410390 Campina da Lagoa;120;33;0;0;0;153
410395 Campina do Simão;21;27;0;0;0;48
410400 Campina Grande do Sul;327;295;0;0;0;622
410405 Campo Bonito;16;0;0;0;0;16
410410 Campo do Tenente;34;31;0;0;0;65
410420 Campo Largo;13835;0;0;0;0;13835
410425 Campo Magro;0;0;0;0;0;0
410430 Campo Mourão;66820;1846;154354;112072;118724;453816
410440 Cândido de Abreu;134;31;0;0;0;165
410442 Candói;45;0;0;0;0;45
410445 Cantagalo;44;54;0;0;0;98
410450 Capanema;0;122;3;0;0;125
410460 Capitão Leônidas Marques;190;113;0;0;0;303
410465 Carambeí;210;189;0;0;0;399
410470 Carlópolis;0;0;0;0;0;0
410480 Cascavel;2368;2390;816;612;0;6186
410490 Castro;782;1046;0;0;0;1828
410500 Catanduvas;126;122;0;0;0;248
410510 Centenário do Sul;109;32;0;0;0;141
410520 Cerro Azul;68;72;0;0;0;140
410530 Céu Azul;63;21;0;0;0;84
410540 Chopinzinho;21488;38070;44132;33522;41121;178333
410550 Cianorte;84172;97951;140945;73136;79422;475626
410560 Cidade Gaúcha;0;0;0;0;0;0
410570 Clevelândia;101;69;0;0;0;170
410580 Colombo;2806;2010;14;0;0;4830
410590 Colorado;87;12;0;0;0;99
410600 Congonhinhas;0;0;0;0;0;0
410610 Conselheiro Mairinck;13;1;0;0;0;14
410620 Contenda;222;0;0;0;0;222
410630 Corbélia;141;40;0;0;0;181
410640 Cornélio Procópio;241;163;0;0;0;404
410645 Coronel Domingos Soares;36;11;0;0;0;47
410650 Coronel Vivida;103;99;0;0;0;202
410655 Corumbataí do Sul;10;24;0;0;0;34
410680 Cruz Machado;0;0;0;0;0;0
410657 Cruzeiro do Iguaçu;0;0;0;0;0;0
410660 Cruzeiro do Oeste;16661;26539;34476;19165;19285;116126
410670 Cruzeiro do Sul;0;0;0;0;0;0
410685 Cruzmaltina;45;58;0;0;0;103
410690 Curitiba;15001;0;0;0;0;15001
410700 Curiúva;21;0;0;0;0;21
410715 Diamante D'Oeste;0;0;0;0;0;0
410710 Diamante do Norte;28;0;0;0;0;28
410712 Diamante do Sul;0;0;0;0;0;0
410720 Dois Vizinhos;43228;37951;0;0;0;81179
410725 Douradina;2264;374;1828;2332;1264;8062
410730 Doutor Camargo;0;0;0;0;0;0
412863 Doutor Ulysses;0;0;0;0;0;0
410740 Enéas Marques;0;0;0;0;0;0
410750 Engenheiro Beltrão;53;33;401;0;0;487
410753 Entre Rios do Oeste;0;0;0;0;0;0
410752 Esperança Nova;8311;21;0;0;4691;13023
410754 Espigão Alto do Iguaçu;41;51;0;0;0;92
410755 Farol;29;0;0;0;0;29
410760 Faxinal;0;0;0;0;0;0
410765 Fazenda Rio Grande;1034;899;0;0;0;1933
410770 Fênix;51;7;0;0;0;58
410773 Fernandes Pinheiro;0;0;0;0;0;0
410775 Figueira;0;0;0;0;0;0
410785 Flor da Serra do Sul;26;17;0;0;6998;7041
410780 Floraí;0;0;0;0;0;0
410790 Floresta;47;16;0;0;0;63
410800 Florestópolis;0;0;0;0;0;0
410810 Flórida;0;0;0;0;0;0
410820 Formosa do Oeste;57;41;0;0;0;98
410830 Foz do Iguaçu;0;0;0;0;0;0
410845 Foz do Jordão;22;22;0;0;0;44
410832 Francisco Alves;330;15236;25058;15695;4478;60797
410840 Francisco Beltrão;1080;1562;0;975;823;4440
410850 General Carneiro;49;6;0;0;0;55
410855 Godoy Moreira;71;58;0;0;0;129
410860 Goioerê;186;55;0;0;0;241
410865 Goioxim;0;0;0;0;0;0
410870 Grandes Rios;0;0;0;0;0;0
410880 Guaíra;0;0;1110;0;0;1110
410890 Guairaçá;45;27;0;0;0;72
410895 Guamiranga;0;0;0;0;0;0
410900 Guapirama;0;0;0;0;0;0
410910 Guaporema;19;19;0;0;0;38
410920 Guaraci;0;0;0;0;0;0
410930 Guaraniaçu;0;0;0;0;0;0
410940 Guarapuava;1971;1687;0;0;59013;62671
410950 Guaraqueçaba;47;44;0;0;0;91
410960 Guaratuba;79;0;0;0;0;79
410965 Honório Serpa;20;7;0;0;0;27
410970 Ibaiti;87;0;0;0;0;87
410975 Ibema;0;0;0;0;0;0
410980 Ibiporã;0;35;0;0;0;35
410990 Icaraíma;23148;30319;47623;20720;0;121810
411000 Iguaraçu;49;41;0;0;0;90
411005 Iguatu;0;0;0;0;0;0
411007 Imbaú;53;2;0;0;0;55
411010 Imbituva;465;330;0;0;0;795
411020 Inácio Martins;0;0;0;0;0;0
411030 Inajá;0;0;0;0;0;0
411040 Indianópolis;0;0;0;0;0;0
411050 Ipiranga;0;0;0;0;0;0
411060 Iporã;120;70;0;0;0;190
411065 Iracema do Oeste;0;22;0;0;0;22
411070 Irati;182;86;0;0;0;268
411080 Iretama;133;115;0;0;0;248
411090 Itaguajé;0;0;0;0;0;0
411095 Itaipulândia;139;148;0;0;0;287
411100 Itambaracá;45;23;0;0;0;68
411110 Itambé;1;27;0;0;0;28
411120 Itapejara d'Oeste;107;88;0;0;0;195
411125 Itaperuçu;0;91;0;0;0;91
411130 Itaúna do Sul;21;3;0;0;0;24
411140 Ivaí;0;0;0;0;0;0
411150 Ivaiporã;273;169;0;0;0;442
411155 Ivaté;61;21;0;0;0;82
411160 Ivatuba;0;0;0;0;0;0
411170 Jaboti;8;6;0;0;0;14
411180 Jacarezinho;148;0;0;0;0;148
411190 Jaguapitã;0;0;0;0;0;0
411200 Jaguariaíva;210;115;0;0;0;325
411210 Jandaia do Sul;0;0;0;0;0;0
411220 Janiópolis;24;14;0;0;0;38
411230 Japira;52;0;0;0;0;52
411240 Japurá;0;17;0;0;0;17
411250 Jardim Alegre;0;0;0;0;0;0
411260 Jardim Olinda;0;0;0;0;0;0
411270 Jataizinho;25;0;0;0;0;25
411275 Jesuítas;0;0;0;0;0;0
411280 Joaquim Távora;44;0;0;0;0;44
411290 Jundiaí do Sul;0;0;0;0;0;0
411295 Juranda;100;55;0;0;0;155
411300 Jussara;0;0;0;0;0;0
411310 Kaloré;0;0;0;0;0;0
411320 Lapa;27;68;0;0;0;95
411325 Laranjal;56;0;0;0;0;56
411330 Laranjeiras do Sul;244;185;0;0;0;429
411340 Leópolis;44;2;0;0;0;46
411342 Lidianópolis;94;77;0;0;0;171
411345 Lindoeste;0;0;0;0;0;0
411350 Loanda;166;0;0;0;0;166
411360 Lobato;0;0;0;0;0;0
411370 Londrina;25134;23462;27477;12821;16848;105742
411373 Luiziana;128;94;0;0;0;222
411375 Lunardelli;30;33;0;0;0;63
411380 Lupionópolis;4;2;0;0;0;6
411390 Mallet;0;0;0;0;0;0
411400 Mamborê;11192;25006;23856;13584;20302;93940
411410 Mandaguaçu;57;59;0;0;0;116
411420 Mandaguari;1576;0;0;7986;14191;23753
411430 Mandirituba;0;0;0;0;0;0
411435 Manfrinópolis;4;1;0;0;0;5
411440 Mangueirinha;135;51;0;0;0;186
411450 Manoel Ribas;0;0;0;0;0;0
411460 Marechal Cândido Rondon;36;35;0;17780;21090;38941
411470 Maria Helena;34;0;0;0;0;34
411480 Marialva;0;0;0;0;0;0
411490 Marilândia do Sul;0;0;0;0;0;0
411500 Marilena;0;0;0;0;0;0
411510 Mariluz;83;35;0;0;0;118
411520 Maringá;2075;293;0;0;0;2368
411530 Mariópolis;41;19;0;0;0;60
411535 Maripá;0;0;0;0;0;0
411540 Marmeleiro;117;90;0;0;0;207
411545 Marquinho;16;41;0;0;0;57
411550 Marumbi;0;0;0;0;0;0
411560 Matelândia;0;0;0;0;0;0
411570 Matinhos;0;0;0;0;0;0
411573 Mato Rico;62;28;0;0;0;90
411575 Mauá da Serra;0;0;0;0;0;0
411580 Medianeira;0;0;0;0;0;0
411585 Mercedes;0;0;0;0;0;0
411590 Mirador;8;9;0;0;0;17
411600 Miraselva;0;0;0;0;0;0
411605 Missal;83;74;0;0;0;157
411610 Moreira Sales;0;0;0;0;0;0
411620 Morretes;0;0;0;0;0;0
411630 Munhoz de Melo;0;0;0;0;0;0
411640 Nossa Senhora das Graças;7;0;0;0;0;7
411650 Nova Aliança do Ivaí;0;0;0;0;0;0
411660 Nova América da Colina;0;0;0;0;0;0
411670 Nova Aurora;92;79;0;0;0;171
411680 Nova Cantu;0;0;0;0;0;0
411690 Nova Esperança;217;128;0;0;0;345
411695 Nova Esperança do Sudoeste;20;17;0;0;0;37
411700 Nova Fátima;0;0;0;0;0;0
411705 Nova Laranjeiras;49;32;0;0;0;81
411710 Nova Londrina;96;85;0;0;0;181
411720 Nova Olímpia;2446;1924;2604;1296;1536;9806
411725 Nova Prata do Iguaçu;98;51;0;0;0;149
411721 Nova Santa Bárbara;0;0;0;0;0;0
411722 Nova Santa Rosa;0;0;0;0;0;0
411727 Nova Tebas;94;59;0;0;0;153
411729 Novo Itacolomi;0;0;0;0;0;0
411730 Ortigueira;156;20;0;0;0;176
411740 Ourizona;0;0;0;0;0;0
411745 Ouro Verde do Oeste;0;0;0;0;0;0
411750 Paiçandu;0;0;0;0;0;0
411760 Palmas;6675;6193;8194;953;173492;195507
411770 Palmeira;0;0;0;0;0;0
411780 Palmital;0;0;0;0;0;0
411790 Palotina;261;0;0;0;0;261
411800 Paraíso do Norte;0;0;0;0;0;0
411810 Paranacity;0;0;0;0;0;0
411820 Paranaguá;0;0;0;0;0;0
411830 Paranapoema;0;0;0;0;0;0
411840 Paranavaí;439;162;0;0;0;601
411845 Pato Bragado;36;14;0;0;0;50
411850 Pato Branco;0;0;0;0;0;0
411860 Paula Freitas;52;24;0;0;0;76
411870 Paulo Frontin;0;0;0;0;0;0
411880 Peabiru;90;0;0;0;0;90
411885 Perobal;80;0;0;0;0;80
411890 Pérola;12879;12166;9048;1210;0;35303
411900 Pérola d'Oeste;0;0;0;0;0;0
411910 Piên;88;152;0;4;0;244
411915 Pinhais;1364;1141;0;0;0;2505
411925 Pinhal de São Bento;10;0;0;0;0;10
411920 Pinhalão;0;0;0;0;0;0
411930 Pinhão;0;90;0;0;0;90
411940 Piraí do Sul;138;0;0;0;0;138
411950 Piraquara;797;572;0;0;0;1369
411960 Pitanga;17;0;0;0;0;17
411965 Pitangueiras;0;0;0;0;0;0
411970 Planaltina do Paraná;2;13;0;0;0;15
411980 Planalto;0;0;0;0;0;0
411990 Ponta Grossa;7456;2355;33;79;0;9923
411995 Pontal do Paraná;201;162;0;0;0;363
412000 Porecatu;0;0;0;0;0;0
412010 Porto Amazonas;0;0;0;0;0;0
412015 Porto Barreiro;28;26;0;0;0;54
412020 Porto Rico;0;0;0;0;0;0
412030 Porto Vitória;14;28;0;0;0;42
412033 Prado Ferreira;0;0;0;0;0;0
412035 Pranchita;47;0;0;0;0;47
412040 Presidente Castelo Branco;0;0;0;0;0;0
412050 Primeiro de Maio;55;43;0;0;0;98
412060 Prudentópolis;476;0;0;0;0;476
412065 Quarto Centenário;27;10;0;0;0;37
412070 Quatiguá;31;0;0;0;0;31
412080 Quatro Barras;44;149;0;0;0;193
412085 Quatro Pontes;0;0;0;0;0;0
412090 Quedas do Iguaçu;525;377;0;0;0;902
412100 Querência do Norte;0;0;0;0;0;0
412110 Quinta do Sol;17;24;0;0;0;41
412120 Quitandinha;0;0;0;0;0;0
412125 Ramilândia;0;0;0;0;0;0
412130 Rancho Alegre;0;0;0;0;0;0
412135 Rancho Alegre D'Oeste;4;0;0;0;0;4
412140 Realeza;115;186;0;0;0;301
412150 Rebouças;33;45;0;0;0;78
412160 Renascença;0;0;0;0;0;0
412170 Reserva;182;117;0;0;0;299
412175 Reserva do Iguaçu;28;19;0;0;0;47
412180 Ribeirão Claro;0;0;0;0;0;0
412190 Ribeirão do Pinhal;2;0;0;0;0;2
412200 Rio Azul;152;78;0;0;0;230
412210 Rio Bom;0;0;0;0;0;0
412215 Rio Bonito do Iguaçu;147;69;0;0;0;216
412217 Rio Branco do Ivaí;59;30;0;0;0;89
412220 Rio Branco do Sul;311;240;0;0;0;551
412230 Rio Negro;241;227;0;0;0;468
412240 Rolândia;693;0;0;0;0;693
412250 Roncador;106;83;0;0;0;189
412260 Rondon;68;48;0;0;0;116
412265 Rosário do Ivaí;92;109;0;0;0;201
412270 Sabáudia;0;0;0;0;0;0
412280 Salgado Filho;2247;2500;250;0;0;4997
412290 Salto do Itararé;28;9;0;0;0;37
412300 Salto do Lontra;28825;19385;22635;3113;10825;84783
412310 Santa Amélia;0;0;0;0;0;0
412320 Santa Cecília do Pavão;0;0;0;0;0;0
412330 Santa Cruz de Monte Castelo;0;2;0;0;0;2
412340 Santa Fé;0;36;0;0;0;36
412350 Santa Helena;144;84;0;0;0;228
412360 Santa Inês;0;0;0;0;0;0
412370 Santa Isabel do Ivaí;20;27;0;0;0;47
412380 Santa Izabel do Oeste;15240;18776;20074;16905;12498;83493
412382 Santa Lúcia;24;17;0;0;0;41
412385 Santa Maria do Oeste;21;19;0;0;0;40
412390 Santa Mariana;90;61;0;0;0;151
412395 Santa Mônica;15;0;0;0;0;15
412402 Santa Tereza do Oeste;0;0;0;0;0;0
412405 Santa Terezinha de Itaipu;79;68;0;0;0;147
412400 Santana do Itararé;56;61;0;0;0;117
412410 Santo Antônio da Platina;211;0;0;0;0;211
412420 Santo Antônio do Caiuá;0;0;0;0;0;0
412430 Santo Antônio do Paraíso;0;0;0;0;0;0
412440 Santo Antônio do Sudoeste;25103;26289;23652;3976;0;79020
412450 Santo Inácio;69;18;0;0;0;87
412460 São Carlos do Ivaí;0;0;0;0;0;0
412470 São Jerônimo da Serra;0;0;0;0;0;0
412480 São João;95;96;24;22;662;899
412490 São João do Caiuá;66;52;0;0;0;118
412500 São João do Ivaí;232;99;0;0;0;331
412510 São João do Triunfo;0;0;0;0;0;0
412520 São Jorge d'Oeste;126;0;0;0;0;126
412530 São Jorge do Ivaí;0;0;0;0;0;0
412535 São Jorge do Patrocínio;8239;68;3531;16154;23656;51648
412540 São José da Boa Vista;92;7;0;0;0;99
412545 São José das Palmeiras;0;0;0;0;0;0
412550 São José dos Pinhais;2812;1932;0;0;0;4744
412555 São Manoel do Paraná;10;3;0;0;0;13
412560 São Mateus do Sul;291;304;0;0;0;595
412570 São Miguel do Iguaçu;157;119;0;0;0;276
412575 São Pedro do Iguaçu;0;0;0;0;0;0
412580 São Pedro do Ivaí;0;0;0;0;0;0
412590 São Pedro do Paraná;0;0;0;0;0;0
412600 São Sebastião da Amoreira;0;9;0;0;0;9
412610 São Tomé;81;36;0;0;0;117
412620 Sapopema;52;24;0;0;0;76
412625 Sarandi;0;0;0;0;0;0
412627 Saudade do Iguaçu;24;20;0;0;0;44
412630 Sengés;34;0;0;0;0;34
412635 Serranópolis do Iguaçu;18;10;0;0;0;28
412640 Sertaneja;35;24;0;0;0;59
412650 Sertanópolis;141;94;0;0;0;235
412660 Siqueira Campos;0;0;0;0;0;0
412665 Sulina;0;0;0;0;0;0
412667 Tamarana;76;68;0;0;0;144
412670 Tamboara;23;6;0;0;0;29
412680 Tapejara;0;0;0;0;0;0
412690 Tapira;34;39;0;0;0;73
412700 Teixeira Soares;0;0;0;0;0;0
412710 Telêmaco Borba;385;242;0;0;0;627
412720 Terra Boa;40490;47390;47016;17775;15496;168167
412730 Terra Rica;135;38;0;0;0;173
412740 Terra Roxa;215;190;0;0;0;405
412750 Tibagi;0;0;0;0;0;0
412760 Tijucas do Sul;0;0;0;0;0;0
412770 Toledo;936;647;0;0;0;1583
412780 Tomazina;2;1;0;0;0;3
412785 Três Barras do Paraná;0;0;0;0;0;0
412788 Tunas do Paraná;75;10;0;0;0;85
412790 Tuneiras do Oeste;1;5;0;0;0;6
412795 Tupãssi;0;0;0;0;0;0
412796 Turvo;175;28;0;0;0;203
412800 Ubiratã;70;1;0;0;0;71
412810 Umuarama;46047;26384;381;14722;17361;104895
412820 União da Vitória;503;395;0;0;0;898
412830 Uniflor;0;0;0;0;0;0
412840 Uraí;14;0;0;0;0;14
412853 Ventania;19;0;0;0;0;19
412855 Vera Cruz do Oeste;57;0;0;0;0;57
412860 Verê;105;79;0;0;0;184
412865 Virmond;73;61;0;0;0;134
412870 Vitorino;0;0;0;0;0;0
412850 Wenceslau Braz;150;119;0;0;0;269
412880 Xambrê;0;0;0;0;0;0
420005 Abdon Batista;0;0;0;5526;12615;18141
420010 Abelardo Luz;5111;4968;5280;4828;33971;54158
420020 Agrolândia;0;0;0;258;0;258
420030 Agronômica;0;0;0;0;0;0
420040 Água Doce;0;0;0;0;5173;5173
420050 Águas de Chapecó;2787;2916;8619;6799;13687;34808
420055 Águas Frias;37274;9016;8938;5816;7588;68632
420060 Águas Mornas;0;0;3922;1465;2874;8261
420070 Alfredo Wagner;30;0;0;0;0;30
420075 Alto Bela Vista;4430;6705;13839;13043;4275;42292
420080 Anchieta;8131;14459;16591;13146;9947;62274
420090 Angelina;0;0;0;0;0;0
420100 Anita Garibaldi;0;0;0;0;0;0
420110 Anitápolis;15;0;4057;7901;4943;16916
420120 Antônio Carlos;28;0;0;0;2480;2508
420125 Apiúna;0;0;0;1;0;1
420127 Arabutã;8347;10686;10494;8814;10391;48732
420130 Araquari;0;228;0;0;0;228
420140 Araranguá;15134;37449;20016;7846;22636;103081
420150 Armazém;0;0;0;0;0;0
420160 Arroio Trinta;850;953;1738;6459;11752;21752
420165 Arvoredo;33;10662;5877;2418;1212;20202
420170 Ascurra;0;0;0;0;0;0
420180 Atalanta;0;0;0;0;0;0
420190 Aurora;0;0;0;0;0;0
420195 Balneário Arroio do Silva;0;0;0;0;0;0
420205 Balneário Barra do Sul;1360;849;796;462;0;3467
420200 Balneário Camboriú;18432;18080;19309;8116;0;63937
420207 Balneário Gaivota;0;0;116;3357;746;4219
421280 Balneário Piçarras;0;0;0;0;0;0
422000 Balneário Rincão;0;1550;0;0;5823;7373
420208 Bandeirante;0;7215;9330;6605;8148;31298
420209 Barra Bonita;2559;2871;3289;2722;5499;16940
420210 Barra Velha;298;50;24;75;154;601
420213 Bela Vista do Toldo;0;0;0;0;0;0
420215 Belmonte;0;0;5799;5160;7282;18241
420220 Benedito Novo;1;1465;786;2425;1905;6582
420230 Biguaçu;498;290;0;0;0;788
420240 Blumenau;15620;10785;10966;11385;23962;72718
420243 Bocaina do Sul;0;0;0;0;0;0
420250 Bom Jardim da Serra;0;0;0;0;922;922
420253 Bom Jesus;2182;2413;2061;1133;1196;8985
420257 Bom Jesus do Oeste;0;4475;14203;11102;9635;39415
420260 Bom Retiro;19;0;0;0;0;19
420245 Bombinhas;188;149;167;128;144;776
420270 Botuverá;4;0;0;0;0;4
420280 Braço do Norte;0;0;654;3840;9385;13879
420285 Braço do Trombudo;0;0;0;0;0;0
420287 Brunópolis;0;0;0;0;66034;66034
420290 Brusque;2193;10308;20451;12085;9310;54347
420300 Caçador;80879;82589;90247;67251;80570;401536
420310 Caibi;8731;25457;25964;18986;24115;103253
420315 Calmon;290;6;0;0;0;296
420320 Camboriú;0;0;0;0;0;0
420330 Campo Alegre;76;68;0;0;0;144
420340 Campo Belo do Sul;0;0;0;0;0;0
420350 Campo Erê;14447;18375;21617;23000;19914;97353
420360 Campos Novos;6766;41669;36031;41461;35460;161387
420370 Canelinha;73;9;0;0;0;82
420380 Canoinhas;31926;42940;73298;46049;50687;244900
420325 Capão Alto;0;0;0;0;0;0
420390 Capinzal;163;121;47;68;0;399
420395 Capivari de Baixo;400;167;0;0;441;1008
420400 Catanduvas;139;1180;3670;2651;2446;10086
420410 Caxambu do Sul;3;0;2446;4438;9101;15988
420415 Celso Ramos;0;0;1464;708;549;2721
420417 Cerro Negro;0;0;0;0;0;0
420419 Chapadão do Lageado;0;0;0;0;0;0
420420 Chapecó;34559;37982;73270;49788;42257;237856
420425 Cocal do Sul;10472;8551;9695;4459;2128;35305
420430 Concórdia;35897;36698;25016;13537;20189;131337
420435 Cordilheira Alta;0;0;0;0;0;0
420440 Coronel Freitas;1921;2500;240;338;0;4999
420445 Coronel Martins;15306;14095;16825;10017;12690;68933
420455 Correia Pinto;0;0;0;0;0;0
420450 Corupá;1090;1090;17061;10032;12526;41799
420460 Criciúma;6674;29521;0;0;13951;50146
420470 Cunha Porã;4199;14429;14056;6860;19469;59013
420475 Cunhataí;6283;8569;12382;11743;12478;51455
420480 Curitibanos;29634;31105;42408;37500;42225;182872
420490 Descanso;2;8;22;2971;25885;28888
420500 Dionísio Cerqueira;12163;35451;37421;18658;50552;154245
420510 Dona Emma;0;0;0;0;0;0
420515 Doutor Pedrinho;0;0;0;0;0;0
420517 Entre Rios;505;469;546;536;276;2332
420519 Ermo;0;0;0;0;0;0
420520 Erval Velho;2505;1863;1242;602;2430;8642
420530 Faxinal dos Guedes;2527;0;2241;916;6885;12569
420535 Flor do Sertão;4251;4468;4116;3263;3558;19656
420540 Florianópolis;237484;254212;249609;138324;160406;1040035
420543 Formosa do Sul;22440;11977;10099;2225;2106;48847
420545 Forquilhinha;3747;302;0;0;4742;8791
420550 Fraiburgo;71731;80987;46076;38295;75950;313039
420555 Frei Rogério;0;0;0;0;0;0
420560 Galvão;8199;10121;14749;2493;8418;43980
420570 Garopaba;9830;10612;10894;13499;12736;57571
420580 Garuva;0;0;0;0;0;0
420590 Gaspar;4653;6125;7942;5273;7427;31420
420600 Governador Celso Ramos;7346;10980;16121;2454;11076;47977
420610 Grão Pará;1074;907;963;658;1175;4777
420620 Gravatal;0;0;0;82;399;481
420630 Guabiruba;4;0;0;0;0;4
420640 Guaraciaba;2212;17700;41355;34752;38909;134928
420650 Guaramirim;540;0;0;0;0;540
420660 Guarujá do Sul;39473;30862;32876;21473;25765;150449
420665 Guatambú;8;0;0;0;1396;1404
420670 Herval d'Oeste;0;6800;9600;9600;9576;35576
420675 Ibiam;556;764;826;0;0;2146
420680 Ibicaré;351;270;524;45;6887;8077
420690 Ibirama;49;20;1487;3843;4782;10181
420700 Içara;5289;2304;8641;3830;4160;24224
420710 Ilhota;0;0;0;0;0;0
420720 Imaruí;0;138;0;0;8225;8363
420730 Imbituba;4197;1971;0;0;71;6239
420740 Imbuia;1;0;0;0;0;1
420750 Indaial;3625;4132;33291;19736;17581;78365
420757 Iomerê;6248;8069;8256;5344;6427;34344
420760 Ipira;3237;2435;2170;0;3628;11470
420765 Iporã do Oeste;18259;18010;0;10038;19483;65790
420768 Ipuaçu;221;392;5080;724;8768;15185
420770 Ipumirim;6805;2100;0;64;2791;11760
420775 Iraceminha;3546;5332;12279;9206;8826;39189
420780 Irani;10636;31858;30998;18650;25093;117235
420785 Irati;32078;7834;7006;5134;6511;58563
420790 Irineópolis;2660;3709;19781;13307;15250;54707
420800 Itá;20621;4293;849;631;7;26401
420810 Itaiópolis;0;0;0;0;0;0
420820 Itajaí;1389;0;0;0;0;1389
420830 Itapema;3;0;0;0;0;3
420840 Itapiranga;13622;22801;4102;4056;16896;61477
420845 Itapoá;0;0;0;9056;25895;34951
420850 Ituporanga;34;0;0;0;0;34
420860 Jaborá;10417;10018;9720;7812;6244;44211
420870 Jacinto Machado;0;0;0;0;0;0
420880 Jaguaruna;0;0;0;0;305;305
420890 Jaraguá do Sul;47229;68536;40976;22802;24159;203702
420895 Jardinópolis;13280;20951;29567;18272;23603;105673
420900 Joaçaba;1026;870;41996;23996;25272;93160
420910 Joinville;30440;27557;32446;25316;23618;139377
420915 José Boiteux;0;0;0;0;0;0
420917 Jupiá;7577;9272;10226;3278;6193;36546
420920 Lacerdópolis;0;0;0;3663;6819;10482
420930 Lages;49462;49470;48948;35737;50307;233924
420940 Laguna;531;19;0;0;0;550
420945 Lajeado Grande;5503;4105;4143;1741;4477;19969
420950 Laurentino;0;0;0;0;0;0
420960 Lauro Muller;0;0;0;0;0;0
420970 Lebon Régis;476;13143;0;0;3750;17369
420980 Leoberto Leal;0;0;0;0;0;0
420985 Lindóia do Sul;0;155;1869;1814;1904;5742
420990 Lontras;0;0;0;0;0;0
421000 Luiz Alves;0;0;0;387;0;387
421003 Luzerna;0;2078;0;0;0;2078
421005 Macieira;0;0;0;0;0;0
421010 Mafra;22601;38256;20884;15092;18934;115767
421020 Major Gercino;0;0;0;2972;6414;9386
421030 Major Vieira;0;0;0;0;0;0
421040 Maracajá;0;0;0;48;0;48
421050 Maravilha;9900;28744;50955;47142;58019;194760
421055 Marema;4;11;570;480;652;1717
421060 Massaranduba;0;0;3147;892;0;4039
421070 Matos Costa;4;0;0;0;0;4
421080 Meleiro;0;0;0;0;0;0
421085 Mirim Doce;0;0;0;0;0;0
421090 Modelo;1828;1837;7195;9061;15671;35592
421100 Mondaí;27747;28563;29374;25437;27996;139117
421105 Monte Carlo;0;0;0;0;0;0
421110 Monte Castelo;22208;36688;50970;15480;17361;142707
421120 Morro da Fumaça;1991;14989;18132;15857;12086;63055
421125 Morro Grande;742;0;0;209;927;1878
421130 Navegantes;0;0;0;0;0;0
421140 Nova Erechim;10644;3450;8543;15794;18153;56584
421145 Nova Itaberaba;6142;3772;5336;3506;0;18756
421150 Nova Trento;21;0;10162;11552;9774;31509
421160 Nova Veneza;0;0;0;0;0;0
421165 Novo Horizonte;0;0;0;0;0;0
421170 Orleans;0;0;0;0;183;183
421175 Otacílio Costa;0;0;0;5228;3740;8968
421180 Ouro;294;0;0;0;0;294
421185 Ouro Verde;3817;0;0;0;0;3817
421187 Paial;4504;3546;120;449;600;9219
421189 Painel;0;0;0;0;0;0
421190 Palhoça;0;0;0;0;0;0
421200 Palma Sola;21435;32600;39453;33280;37528;164296
421205 Palmeira;0;0;0;0;0;0
421210 Palmitos;32;2504;998;4063;7564;15161
421220 Papanduva;0;0;620;0;0;620
421223 Paraíso;6233;8456;1561;4200;7051;27501
421225 Passo de Torres;0;0;0;0;343;343
421227 Passos Maia;0;1887;6319;7224;7756;23186
421230 Paulo Lopes;0;15330;24841;11272;14454;65897
421240 Pedras Grandes;0;0;0;0;0;0
421250 Penha;0;0;0;0;0;0
421260 Peritiba;3832;2493;4841;5177;4927;21270
421265 Pescaria Brava;0;0;0;13;0;13
421270 Petrolândia;0;0;0;0;0;0
421290 Pinhalzinho;24020;63;0;0;0;24083
421300 Pinheiro Preto;4059;3200;0;0;0;7259
421310 Piratuba;2552;4669;6000;5292;6000;24513
421315 Planalto Alegre;0;903;1704;938;649;4194
421320 Pomerode;468;354;26;0;0;848
421330 Ponte Alta;0;0;0;0;0;0
421335 Ponte Alta do Norte;11;0;0;0;0;11
421340 Ponte Serrada;3600;3600;10682;13509;16345;47736
421350 Porto Belo;0;0;0;0;0;0
421360 Porto União;19758;22942;34135;18734;23649;119218
421370 Pouso Redondo;0;0;0;0;0;0
421380 Praia Grande;0;0;0;0;0;0
421390 Presidente Castello Branco;0;0;0;0;0;0
421400 Presidente Getúlio;0;0;0;0;0;0
421410 Presidente Nereu;0;0;0;0;0;0
421415 Princesa;15013;22588;19337;14378;15846;87162
421420 Quilombo;19286;27520;29485;24043;21566;121900
421430 Rancho Queimado;0;0;0;0;0;0
421440 Rio das Antas;9931;3447;0;800;503;14681
421450 Rio do Campo;0;0;0;0;7909;7909
421460 Rio do Oeste;0;0;0;0;0;0
421480 Rio do Sul;7259;239;0;0;0;7498
421470 Rio dos Cedros;13;0;0;0;0;13
421490 Rio Fortuna;501;761;1015;470;440;3187
421500 Rio Negrinho;14005;31803;53403;29729;23865;152805
421505 Rio Rufino;0;0;0;0;0;0
421507 Riqueza;18882;18109;20316;18048;17505;92860
421510 Rodeio;0;0;0;0;0;0
421520 Romelândia;3587;1946;2554;2265;4897;15249
421530 Salete;0;0;0;0;0;0
421535 Saltinho;9657;9080;11572;10504;11817;52630
421540 Salto Veloso;30;26;0;0;0;56
421545 Sangão;1927;2126;1426;1080;2461;9020
421550 Santa Cecília;3571;2592;1841;645;1913;10562
421555 Santa Helena;76;4282;2174;1856;6140;14528
421560 Santa Rosa de Lima;0;0;0;0;0;0
421565 Santa Rosa do Sul;0;0;0;0;0;0
421567 Santa Terezinha;0;0;0;0;0;0
421568 Santa Terezinha do Progresso;9886;13249;14744;6061;6811;50751
421569 Santiago do Sul;12571;6536;5085;2561;12007;38760
421570 Santo Amaro da Imperatriz;40;31;0;0;5205;5276
421580 São Bento do Sul;811;857;0;0;808;2476
421575 São Bernardino;610;28;700;737;5572;7647
421590 São Bonifácio;0;0;11065;8929;9943;29937
421600 São Carlos;3606;3539;3223;2743;2673;15784
421605 São Cristovão do Sul;0;0;0;0;1046;1046
421610 São Domingos;1008;864;18243;19091;20583;59789
421620 São Francisco do Sul;4140;7730;3023;136;0;15029
421630 São João Batista;0;0;0;0;0;0
421635 São João do Itaperiú;0;289;4464;1737;4987;11477
421625 São João do Oeste;18247;20616;23918;17790;18802;99373
421640 São João do Sul;0;0;0;0;0;0
421650 São Joaquim;0;0;0;0;0;0
421660 São José;700;166;0;0;0;866
421670 São José do Cedro;8020;10076;12000;11989;40047;82132
421680 São José do Cerrito;0;0;0;0;0;0
421690 São Lourenço do Oeste;33613;22444;17914;10482;11073;95526
421700 São Ludgero;0;0;0;0;0;0
421710 São Martinho;0;0;0;0;0;0
421715 São Miguel da Boa Vista;2266;5495;12448;5670;8386;34265
421720 São Miguel do Oeste;46701;47935;45516;31339;33482;204973
421725 São Pedro de Alcântara;0;0;2109;437;1413;3959
421730 Saudades;12722;16255;20032;12893;20728;82630
421740 Schroeder;1200;1200;1200;977;1100;5677
421750 Seara;7604;1178;6;0;2850;11638
421755 Serra Alta;1897;3000;4965;8059;13409;31330
421760 Siderópolis;1178;1877;1667;862;826;6410
421770 Sombrio;0;10210;7975;4553;19966;42704
421775 Sul Brasil;232;7660;7497;0;12227;27616
421780 Taió;0;0;0;0;0;0
421790 Tangará;4753;16943;19065;8278;14781;63820
421795 Tigrinhos;1577;1571;6715;6745;9248;25856
421800 Tijucas;164;0;0;0;0;164
421810 Timbé do Sul;0;0;0;0;2709;2709
421820 Timbó;11583;3780;2748;0;704;18815
421825 Timbó Grande;1596;1416;10504;21885;3000;38401
421830 Três Barras;18;0;0;0;0;18
421835 Treviso;342;508;367;35;669;1921
421840 Treze de Maio;0;0;7;0;300;307
421850 Treze Tílias;1371;139;2543;1997;928;6978
421860 Trombudo Central;23;0;0;0;0;23
421870 Tubarão;10819;14300;12913;22896;18751;79679
421875 Tunápolis;16616;15743;13748;10932;12561;69600
421880 Turvo;0;0;1587;159;0;1746
421885 União do Oeste;226;9885;16630;8835;23708;59284
421890 Urubici;0;0;0;0;0;0
421895 Urupema;0;0;0;0;0;0
421900 Urussanga;0;0;0;0;0;0
421910 Vargeão;1090;1231;1634;1643;2479;8077
421915 Vargem;0;4668;6231;3337;4164;18400
421917 Vargem Bonita;1341;1282;550;0;343;3516
421920 Vidal Ramos;0;0;0;0;2214;2214
421930 Videira;2020;0;0;0;0;2020
421935 Vitor Meireles;0;0;0;0;0;0
421940 Witmarsum;0;0;0;0;1;1
421950 Xanxerê;189;19067;38183;25207;29220;111866
421960 Xavantina;0;0;0;0;0;0
421970 Xaxim;0;5774;17025;9156;21056;53011
421985 Zortéa;0;0;0;0;0;0
430003 Aceguá;6005;957;0;0;0;6962
430005 Água Santa;11;3;0;0;0;14
430010 Agudo;7047;330;0;0;0;7377
430020 Ajuricaba;0;0;0;0;0;0
430030 Alecrim;0;0;0;0;0;0
430040 Alegrete;1468;4589;43181;8324;11846;69408
430045 Alegria;0;0;0;0;0;0
430047 Almirante Tamandaré do Sul;5;1;0;0;0;6
430050 Alpestre;0;0;0;0;0;0
430055 Alto Alegre;0;0;0;0;0;0
430057 Alto Feliz;0;0;0;0;0;0
430060 Alvorada;1235;0;0;0;0;1235
430063 Amaral Ferrador;0;0;0;0;0;0
430064 Ametista do Sul;9;7;0;0;0;16
430066 André da Rocha;0;0;0;0;0;0
430070 Anta Gorda;10;0;0;0;0;10
430080 Antônio Prado;86;39;0;1;3;129
430085 Arambaré;0;0;0;0;0;0
430087 Araricá;6211;1528;0;0;0;7739
430090 Aratiba;6;2;0;0;0;8
430100 Arroio do Meio;0;0;0;0;0;0
430107 Arroio do Padre;722;0;0;0;0;722
430105 Arroio do Sal;1188;400;0;0;0;1588
430120 Arroio do Tigre;0;0;0;0;0;0
430110 Arroio dos Ratos;0;0;0;0;0;0
430130 Arroio Grande;0;19;14;0;0;33
430140 Arvorezinha;0;0;0;0;0;0
430150 Augusto Pestana;0;0;0;0;0;0
430155 Áurea;0;0;0;0;0;0
430160 Bagé;349949;32141;0;0;0;382090
430163 Balneário Pinhal;0;0;0;0;0;0
430165 Barão;20320;3503;0;0;0;23823
430170 Barão de Cotegipe;32;0;0;0;0;32
430175 Barão do Triunfo;8;0;0;0;0;8
430185 Barra do Guarita;0;0;0;0;0;0
430187 Barra do Quaraí;22846;22634;6729;0;0;52209
430190 Barra do Ribeiro;0;0;0;0;0;0
430192 Barra do Rio Azul;0;0;0;0;0;0
430195 Barra Funda;6;4;0;0;0;10
430180 Barracão;0;0;0;0;0;0
430200 Barros Cassal;0;0;0;0;0;0
430205 Benjamin Constant do Sul;0;0;0;0;0;0
430210 Bento Gonçalves;863;704;0;0;0;1567
430215 Boa Vista das Missões;0;0;0;0;0;0
430220 Boa Vista do Buricá;0;0;0;0;0;0
430222 Boa Vista do Cadeado;0;0;0;0;0;0
430223 Boa Vista do Incra;0;0;0;0;0;0
430225 Boa Vista do Sul;0;0;0;0;0;0
430230 Bom Jesus;0;22;249;147;82;500
430235 Bom Princípio;0;0;0;0;0;0
430237 Bom Progresso;0;0;0;0;0;0
430240 Bom Retiro do Sul;0;0;0;0;0;0
430245 Boqueirão do Leão;0;0;0;0;0;0
430250 Bossoroca;0;0;0;0;0;0
430258 Bozano;0;0;0;0;0;0
430260 Braga;0;0;0;0;0;0
430265 Brochier;0;0;0;0;0;0
430270 Butiá;0;0;0;0;0;0
430280 Caçapava do Sul;90942;0;0;0;0;90942
430290 Cacequi;7340;0;8;1715;560;9623
430300 Cachoeira do Sul;73721;67165;73031;32423;24913;271253
430310 Cachoeirinha;0;0;0;0;0;0
430320 Cacique Doble;17;4;0;0;0;21
430330 Caibaté;5;0;0;0;0;5
430340 Caiçara;2;0;0;0;0;2
430350 Camaquã;79032;9802;0;0;0;88834
430355 Camargo;17;10;0;0;0;27
430360 Cambará do Sul;0;0;0;0;0;0
430367 Campestre da Serra;0;0;0;0;0;0
430370 Campina das Missões;0;0;0;0;0;0
430380 Campinas do Sul;5;0;0;0;0;5
430390 Campo Bom;0;0;0;0;0;0
430400 Campo Novo;0;0;0;0;0;0
430410 Campos Borges;29;6;0;0;0;35
430420 Candelária;188;145;5247;16254;17791;39625
430430 Cândido Godói;49;14;0;0;0;63
430435 Candiota;0;0;0;0;0;0
430440 Canela;56403;57588;42764;20080;14474;191309
430450 Canguçu;23489;0;0;0;0;23489
430460 Canoas;1284;1124;0;0;0;2408
430461 Canudos do Vale;0;0;0;0;0;0
430462 Capão Bonito do Sul;1;0;0;0;0;1
430463 Capão da Canoa;6000;2484;0;0;0;8484
430465 Capão do Cipó;6;0;0;0;0;6
430466 Capão do Leão;0;0;0;0;0;0
430468 Capela de Santana;0;0;0;0;0;0
430469 Capitão;0;0;0;0;0;0
430467 Capivari do Sul;6978;393;0;0;0;7371
430471 Caraá;2;0;0;0;0;2
430470 Carazinho;20340;20910;7089;833;1016;50188
430480 Carlos Barbosa;7870;14664;14436;12534;14424;63928
430485 Carlos Gomes;0;0;0;0;0;0
430490 Casca;15;10;0;0;0;25
430495 Caseiros;0;0;0;0;0;0
430500 Catuípe;0;0;0;0;0;0
430510 Caxias do Sul;9336;12697;9297;10279;12401;54010
430511 Centenário;3;0;0;0;0;3
430512 Cerrito;37;22;0;0;0;59
430513 Cerro Branco;0;0;0;0;0;0
430515 Cerro Grande;0;0;0;0;0;0
430517 Cerro Grande do Sul;0;0;0;0;0;0
430520 Cerro Largo;0;0;0;0;0;0
430530 Chapada;0;0;0;0;0;0
430535 Charqueadas;0;0;0;0;0;0
430537 Charrua;0;0;0;0;0;0
430540 Chiapetta;0;0;0;0;0;0
430543 Chuí;0;0;0;0;0;0
430544 Chuvisca;0;0;0;0;0;0
430545 Cidreira;0;0;0;0;0;0
430550 Ciríaco;0;0;0;0;0;0
430558 Colinas;0;0;0;0;0;0
430560 Colorado;0;0;0;0;0;0
430570 Condor;0;0;0;0;0;0
430580 Constantina;0;0;0;0;0;0
430583 Coqueiro Baixo;0;0;0;0;0;0
430585 Coqueiros do Sul;0;6;0;0;0;6
430587 Coronel Barros;0;0;0;0;0;0
430590 Coronel Bicaco;0;0;0;0;0;0
430593 Coronel Pilar;0;0;0;0;0;0
430595 Cotiporã;0;0;0;0;0;0
430597 Coxilha;0;0;0;0;0;0
430600 Crissiumal;0;0;0;0;0;0
430605 Cristal;0;0;0;0;0;0
430607 Cristal do Sul;0;0;0;0;0;0
430610 Cruz Alta;490;35793;42034;27814;34898;141029
430613 Cruzaltense;1;0;0;0;0;1
430620 Cruzeiro do Sul;0;0;0;0;0;0
430630 David Canabarro;0;0;0;0;0;0
430632 Derrubadas;0;0;0;0;0;0
430635 Dezesseis de Novembro;0;0;0;0;0;0
430637 Dilermando de Aguiar;3;0;0;0;0;3
430640 Dois Irmãos;0;0;0;0;0;0
430642 Dois Irmãos das Missões;0;0;0;0;0;0
430645 Dois Lajeados;0;0;0;0;0;0
430650 Dom Feliciano;0;0;0;0;0;0
430660 Dom Pedrito;97837;9044;0;0;0;106881
430655 Dom Pedro de Alcântara;0;0;0;0;0;0
430670 Dona Francisca;25;0;0;0;0;25
430673 Doutor Maurício Cardoso;0;0;0;0;0;0
430675 Doutor Ricardo;0;0;0;0;0;0
430676 Eldorado do Sul;0;0;0;0;0;0
430680 Encantado;0;0;0;0;0;0
430690 Encruzilhada do Sul;86055;90;0;0;0;86145
430692 Engenho Velho;0;0;0;0;0;0
430695 Entre Rios do Sul;0;0;0;0;0;0
430693 Entre-Ijuís;13;30;3;0;0;46
430697 Erebango;11;0;0;0;0;11
430700 Erechim;503;148;0;0;0;651
430705 Ernestina;1;0;0;0;0;1
430720 Erval Grande;25;0;0;0;0;25
430730 Erval Seco;0;0;0;2838;2989;5827
430740 Esmeralda;0;0;0;0;0;0
430745 Esperança do Sul;0;0;0;0;0;0
430750 Espumoso;16;0;0;0;0;16
430755 Estação;0;0;0;0;0;0
430760 Estância Velha;190;0;0;0;0;190
430770 Esteio;125;41;0;0;0;166
430780 Estrela;11541;9019;14577;8421;7963;51521
430781 Estrela Velha;50;47;0;0;0;97
430783 Eugênio de Castro;6;0;0;0;0;6
430786 Fagundes Varela;0;0;0;0;0;0
430790 Farroupilha;2405;1016;1454;1364;2483;8722
430800 Faxinal do Soturno;5;0;0;0;0;5
430805 Faxinalzinho;3;0;0;0;0;3
430807 Fazenda Vilanova;0;0;0;0;0;0
430810 Feliz;34;0;0;0;0;34
430820 Flores da Cunha;128;128;0;0;0;256
430825 Floriano Peixoto;7;0;0;0;0;7
430830 Fontoura Xavier;0;0;0;0;0;0
430840 Formigueiro;0;0;0;0;0;0
430843 Forquetinha;0;0;0;0;0;0
430845 Fortaleza dos Valos;9;0;0;0;0;9
430850 Frederico Westphalen;0;0;0;0;0;0
430860 Garibaldi;117;37;0;0;0;154
430865 Garruchos;0;0;0;0;0;0
430870 Gaurama;0;0;0;0;0;0
430880 General Câmara;6;7;0;0;0;13
430885 Gentil;0;0;0;0;0;0
430890 Getúlio Vargas;54;0;0;0;0;54
430900 Giruá;28754;43389;44850;20198;24229;161420
430905 Glorinha;0;0;0;0;0;0
430910 Gramado;29812;30512;39943;12262;20118;132647
430912 Gramado dos Loureiros;26;1;0;0;0;27
430915 Gramado Xavier;0;0;0;0;0;0
430920 Gravataí;0;0;0;0;0;0
430925 Guabiju;0;0;0;0;0;0
430930 Guaíba;184;132;0;0;0;316
430940 Guaporé;71;41;0;500;20;632
430950 Guarani das Missões;0;0;0;0;0;0
430955 Harmonia;13043;1640;0;0;0;14683
430710 Herval;0;0;0;0;0;0
430957 Herveiras;0;0;0;0;0;0
430960 Horizontina;46;18;0;0;0;64
430965 Hulha Negra;0;0;0;0;0;0
430970 Humaitá;0;0;0;0;0;0
430975 Ibarama;48;0;0;0;0;48
430980 Ibiaçá;3648;0;6967;8620;0;19235
430990 Ibiraiaras;0;0;0;0;0;0
430995 Ibirapuitã;0;0;0;0;0;0
431000 Ibirubá;97;0;0;0;0;97
431010 Igrejinha;73622;7951;0;0;0;81573
431020 Ijuí;420;10;0;0;0;430
431030 Ilópolis;3;0;0;0;0;3
431033 Imbé;0;0;0;0;0;0
431036 Imigrante;3;0;0;0;0;3
431040 Independência;0;0;0;0;0;0
431041 Inhacorá;0;0;0;0;0;0
431043 Ipê;0;0;0;0;0;0
431046 Ipiranga do Sul;0;0;0;0;0;0
431050 Iraí;33;0;652;4164;7415;12264
431053 Itaara;39;19;0;0;0;58
431055 Itacurubi;0;0;0;0;0;0
431057 Itapuca;6;1;0;0;0;7
431060 Itaqui;6870;4910;700;0;0;12480
431065 Itati;0;0;0;0;0;0
431070 Itatiba do Sul;0;0;0;0;0;0
431075 Ivorá;0;0;0;0;0;0
431080 Ivoti;14;22;0;0;0;36
431085 Jaboticaba;0;0;0;0;0;0
431087 Jacuizinho;1;0;0;0;0;1
431090 Jacutinga;0;0;0;0;0;0
431100 Jaguarão;12843;0;0;0;0;12843
431110 Jaguari;1;0;0;0;0;1
431112 Jaquirana;0;0;0;0;110;110
431113 Jari;10;0;0;0;0;10
431115 Jóia;0;0;0;0;0;0
431120 Júlio de Castilhos;97;0;0;0;0;97
431123 Lagoa Bonita do Sul;0;0;0;0;0;0
431127 Lagoa dos Três Cantos;0;0;0;0;0;0
431130 Lagoa Vermelha;167;109;0;0;0;276
431125 Lagoão;0;0;0;0;0;0
431140 Lajeado;35732;42268;36481;13749;12987;141217
431142 Lajeado do Bugre;0;0;0;0;0;0
431150 Lavras do Sul;0;0;0;0;0;0
431160 Liberato Salzano;0;0;0;0;0;0
431162 Lindolfo Collor;0;0;0;0;0;0
431164 Linha Nova;0;0;0;0;0;0
431171 Maçambará;0;0;0;0;0;0
431170 Machadinho;38;0;0;0;0;38
431173 Mampituba;0;0;0;0;0;0
431175 Manoel Viana;0;0;0;0;167;167
431177 Maquiné;0;0;0;0;0;0
431179 Maratá;2;0;0;0;0;2
431180 Marau;263;183;0;0;0;446
431190 Marcelino Ramos;13;0;0;0;0;13
431198 Mariana Pimentel;0;0;0;0;0;0
431200 Mariano Moro;0;0;0;0;0;0
431205 Marques de Souza;0;0;0;0;0;0
431210 Mata;0;0;0;0;0;0
431213 Mato Castelhano;0;0;0;0;0;0
431215 Mato Leitão;21;0;0;0;0;21
431217 Mato Queimado;0;0;0;0;0;0
431220 Maximiliano de Almeida;14;15;0;0;0;29
431225 Minas do Leão;0;0;0;0;0;0
431230 Miraguaí;0;0;0;0;0;0
431235 Montauri;0;0;0;0;0;0
431237 Monte Alegre dos Campos;0;0;0;0;0;0
431238 Monte Belo do Sul;1;0;0;0;0;1
431240 Montenegro;25080;2865;0;0;0;27945
431242 Mormaço;0;0;0;0;0;0
431244 Morrinhos do Sul;5200;3138;0;0;0;8338
431245 Morro Redondo;0;0;0;0;0;0
431247 Morro Reuter;4577;196;0;0;0;4773
431250 Mostardas;10;0;0;0;0;10
431260 Muçum;0;0;0;0;0;0
431261 Muitos Capões;0;0;0;0;0;0
431262 Muliterno;0;0;0;0;0;0
431265 Não-Me-Toque;102;86;0;0;0;188
431267 Nicolau Vergueiro;0;0;0;0;0;0
431270 Nonoai;41;0;0;0;0;41
431275 Nova Alvorada;26;0;0;0;0;26
431280 Nova Araçá;38;13;88;3218;576;3933
431290 Nova Bassano;0;0;0;0;0;0
431295 Nova Boa Vista;0;0;0;0;0;0
431300 Nova Bréscia;0;0;0;0;0;0
431301 Nova Candelária;0;0;0;0;0;0
431303 Nova Esperança do Sul;1;0;0;0;0;1
431306 Nova Hartz;0;0;0;0;0;0
431308 Nova Pádua;0;0;0;0;0;0
431310 Nova Palma;2;7;0;0;0;9
431320 Nova Petrópolis;7715;9318;8217;7458;10042;42750
431330 Nova Prata;142;974;2981;8001;6763;18861
431333 Nova Ramada;0;0;0;0;0;0
431335 Nova Roma do Sul;0;0;0;0;0;0
431337 Nova Santa Rita;0;0;0;0;0;0
431349 Novo Barreiro;0;0;0;0;0;0
431339 Novo Cabrais;0;0;0;0;0;0
431340 Novo Hamburgo;0;0;0;0;0;0
431342 Novo Machado;0;0;0;0;0;0
431344 Novo Tiradentes;0;0;0;0;0;0
431346 Novo Xingu;0;0;0;0;0;0
431350 Osório;5741;2664;7796;32994;20374;69569
431360 Paim Filho;0;0;0;0;0;0
431365 Palmares do Sul;70;41;20;110;88;329
431370 Palmeira das Missões;0;0;0;0;0;0
431380 Palmitinho;0;0;0;0;0;0
431390 Panambi;172;122;0;0;0;294
431395 Pantano Grande;56;2;0;0;0;58
431400 Paraí;14;2;0;0;0;16
431402 Paraíso do Sul;0;0;0;0;0;0
431403 Pareci Novo;0;0;0;0;0;0
431405 Parobé;539;305;0;0;0;844
431406 Passa Sete;9;5;0;0;0;14
431407 Passo do Sobrado;0;0;0;0;0;0
431410 Passo Fundo;0;0;0;0;0;0
431413 Paulo Bento;0;0;0;0;0;0
431415 Paverama;0;0;0;0;0;0
431417 Pedras Altas;0;0;0;0;0;0
431420 Pedro Osório;0;0;0;0;0;0
431430 Pejuçara;0;0;0;0;0;0
431440 Pelotas;462;519;0;0;0;981
431442 Picada Café;4177;3206;1814;2010;3642;14849
431445 Pinhal;0;0;0;0;0;0
431446 Pinhal da Serra;0;3627;5823;4084;6934;20468
431447 Pinhal Grande;0;0;0;0;0;0
431449 Pinheirinho do Vale;0;0;0;0;0;0
431450 Pinheiro Machado;0;0;0;0;0;0
431454 Pinto Bandeira;0;0;0;0;0;0
431455 Pirapó;0;0;0;0;0;0
431460 Piratini;0;0;0;0;0;0
431470 Planalto;69;0;0;0;0;69
431475 Poço das Antas;9;13;0;0;0;22
431477 Pontão;0;0;0;0;0;0
431478 Ponte Preta;0;0;0;0;0;0
431480 Portão;70;95;0;0;0;165
431490 Porto Alegre;402;86;663;909;124;2184
431500 Porto Lucena;0;1;0;0;0;1
431505 Porto Mauá;0;0;0;0;0;0
431507 Porto Vera Cruz;0;0;0;0;0;0
431510 Porto Xavier;0;0;0;0;2952;2952
431513 Pouso Novo;12;3;0;0;0;15
431514 Presidente Lucena;1654;331;0;0;0;1985
431515 Progresso;0;0;0;0;0;0
431517 Protásio Alves;0;0;0;0;0;0
431520 Putinga;0;0;0;0;0;0
431530 Quaraí;103077;108717;116115;83309;75723;486941
431531 Quatro Irmãos;0;0;0;0;0;0
431532 Quevedos;0;0;0;0;0;0
431535 Quinze de Novembro;6;0;0;0;0;6
431540 Redentora;0;0;0;0;0;0
431545 Relvado;0;0;0;0;0;0
431550 Restinga Seca;5995;8026;8677;3274;5542;31514
431555 Rio dos Índios;17;0;0;0;0;17
431560 Rio Grande;24413;0;0;0;0;24413
431570 Rio Pardo;3508;133;403;0;0;4044
431575 Riozinho;0;0;0;0;0;0
431580 Roca Sales;10;0;0;0;0;10
431590 Rodeio Bonito;0;3421;11664;9241;10224;34550
431595 Rolador;0;0;0;0;0;0
431600 Rolante;18077;5499;0;0;0;23576
431610 Ronda Alta;0;0;0;0;0;0
431620 Rondinha;17;9;0;0;0;26
431630 Roque Gonzales;0;0;0;0;0;0
431640 Rosário do Sul;0;0;0;0;0;0
431642 Sagrada Família;0;0;0;0;0;0
431643 Saldanha Marinho;0;0;0;0;0;0
431645 Salto do Jacuí;0;0;0;0;0;0
431647 Salvador das Missões;0;0;0;0;0;0
431650 Salvador do Sul;17906;13203;10432;6185;4951;52677
431660 Sananduva;123;61;0;0;0;184
431710 Sant'Ana do Livramento;123124;96287;89696;140350;71907;521364
431670 Santa Bárbara do Sul;0;0;0;0;0;0
431673 Santa Cecília do Sul;17;0;0;0;0;17
431675 Santa Clara do Sul;0;0;0;0;0;0
431680 Santa Cruz do Sul;494;289;15;0;0;798
431697 Santa Margarida do Sul;0;0;0;0;0;0
431690 Santa Maria;83382;8222;0;0;0;91604
431695 Santa Maria do Herval;2826;500;0;0;0;3326
431720 Santa Rosa;97248;100376;91586;49542;42008;380760
431725 Santa Tereza;0;0;0;0;0;0
431730 Santa Vitória do Palmar;0;0;0;0;0;0
431700 Santana da Boa Vista;0;0;0;0;0;0
431740 Santiago;45598;4057;15;0;0;49670
431750 Santo Ângelo;157;321;0;0;0;478
431760 Santo Antônio da Patrulha;699;688;0;0;0;1387
431770 Santo Antônio das Missões;0;0;0;0;0;0
431755 Santo Antônio do Palma;0;0;0;0;0;0
431775 Santo Antônio do Planalto;0;0;0;0;0;0
431780 Santo Augusto;0;0;0;0;7013;7013
431790 Santo Cristo;0;0;0;0;0;0
431795 Santo Expedito do Sul;0;0;0;0;0;0
431800 São Borja;23798;22591;26448;20545;40469;133851
431805 São Domingos do Sul;0;0;0;0;0;0
431810 São Francisco de Assis;0;0;0;0;0;0
431820 São Francisco de Paula;0;0;0;0;0;0
431830 São Gabriel;0;4200;4718;2127;2932;13977
431840 São Jerônimo;0;0;0;0;0;0
431842 São João da Urtiga;0;8;0;0;0;8
431843 São João do Polêsine;2;0;0;0;0;2
431844 São Jorge;0;0;0;0;0;0
431845 São José das Missões;0;0;0;0;0;0
431846 São José do Herval;0;0;0;0;0;0
431848 São José do Hortêncio;0;0;0;0;0;0
431849 São José do Inhacorá;0;0;0;0;0;0
431850 São José do Norte;0;0;0;0;0;0
431860 São José do Ouro;0;0;0;0;0;0
431861 São José do Sul;0;0;0;0;0;0
431862 São José dos Ausentes;0;0;0;0;0;0
431870 São Leopoldo;362;225;0;0;0;587
431880 São Lourenço do Sul;20475;119;0;0;0;20594
431890 São Luiz Gonzaga;0;0;0;0;0;0
431900 São Marcos;8158;7916;7988;7208;5318;36588
431910 São Martinho;0;0;0;0;0;0
431912 São Martinho da Serra;13;6;0;0;0;19
431915 São Miguel das Missões;0;0;0;0;0;0
431920 São Nicolau;0;0;0;0;0;0
431930 São Paulo das Missões;0;0;0;0;0;0
431935 São Pedro da Serra;21;0;0;0;0;21
431936 São Pedro das Missões;0;0;0;0;0;0
431937 São Pedro do Butiá;8;0;0;0;0;8
431940 São Pedro do Sul;1057;969;0;0;0;2026
431950 São Sebastião do Caí;3568;0;0;0;0;3568
431960 São Sepé;2351;838;0;0;0;3189
431970 São Valentim;0;0;0;0;0;0
431971 São Valentim do Sul;0;0;0;0;0;0
431973 São Valério do Sul;0;0;0;0;0;0
431975 São Vendelino;10;2;0;0;0;12
431980 São Vicente do Sul;0;0;0;0;0;0
431990 Sapiranga;305;148;0;0;0;453
432000 Sapucaia do Sul;0;0;0;0;0;0
432010 Sarandi;0;0;0;0;0;0
432020 Seberi;83;16583;16686;13767;15818;62937
432023 Sede Nova;0;0;0;0;0;0
432026 Segredo;0;0;0;0;0;0
432030 Selbach;19;0;0;0;0;19
432032 Senador Salgado Filho;9;25;0;0;0;34
432035 Sentinela do Sul;0;0;0;0;0;0
432040 Serafina Corrêa;33870;0;0;0;0;33870
432045 Sério;0;0;0;0;0;0
432050 Sertão;7;0;0;0;0;7
432055 Sertão Santana;0;0;0;0;0;0
432057 Sete de Setembro;0;0;0;0;0;0
432060 Severiano de Almeida;15;7;0;0;0;22
432065 Silveira Martins;14;0;0;0;0;14
432067 Sinimbu;27;4;0;0;0;31
432070 Sobradinho;13898;78;0;0;0;13976
432080 Soledade;106;37;0;0;0;143
432085 Tabaí;0;0;0;0;0;0
432090 Tapejara;118;0;0;0;0;118
432100 Tapera;0;0;0;0;0;0
432110 Tapes;0;0;0;0;0;0
432120 Taquara;289;96;0;0;0;385
432130 Taquari;0;0;0;0;0;0
432132 Taquaruçu do Sul;0;0;0;2498;12225;14723
432135 Tavares;0;0;0;0;0;0
432140 Tenente Portela;0;0;0;0;0;0
432143 Terra de Areia;0;0;0;0;0;0
432145 Teutônia;0;31169;28341;29795;27420;116725
432146 Tio Hugo;18;19;0;0;0;37
432147 Tiradentes do Sul;0;0;0;0;0;0
432149 Toropi;5;0;0;0;0;5
432150 Torres;154;27;0;0;0;181
432160 Tramandaí;75;202;2;3;0;282
432162 Travesseiro;0;0;0;0;0;0
432163 Três Arroios;0;0;0;0;0;0
432166 Três Cachoeiras;45;0;0;0;0;45
432170 Três Coroas;84148;20795;0;0;0;104943
432180 Três de Maio;12084;0;0;0;0;12084
432183 Três Forquilhas;0;0;0;0;0;0
432185 Três Palmeiras;0;0;0;0;0;0
432190 Três Passos;126;0;0;0;0;126
432195 Trindade do Sul;32;11;0;0;0;43
432200 Triunfo;22;0;0;0;0;22
432210 Tucunduva;36;6;0;0;0;42
432215 Tunas;0;0;0;0;0;0
432218 Tupanci do Sul;6;3;0;0;0;9
432220 Tupanciretã;0;0;0;0;0;0
432225 Tupandi;19160;3456;0;0;0;22616
432230 Tuparendi;0;0;0;0;0;0
432232 Turuçu;796;2;0;0;0;798
432234 Ubiretama;0;0;0;0;0;0
432235 União da Serra;0;0;0;0;0;0
432237 Unistalda;13;0;0;0;0;13
432240 Uruguaiana;200790;220597;258858;103818;117844;901907
432250 Vacaria;6809;75609;55150;29048;41761;208377
432253 Vale do Sol;0;0;0;0;0;0
432254 Vale Real;3;3;0;0;0;6
432252 Vale Verde;19;0;0;0;0;19
432255 Vanini;0;0;0;0;0;0
432260 Venâncio Aires;56499;66608;93060;31235;45533;292935
432270 Vera Cruz;26232;29983;26025;15719;0;97959
432280 Veranópolis;25190;29558;34220;18500;15707;123175
432285 Vespasiano Correa;0;0;0;0;0;0
432290 Viadutos;0;0;0;0;0;0
432300 Viamão;0;0;0;0;0;0
432310 Vicente Dutra;0;0;0;0;0;0
432320 Victor Graeff;0;0;0;0;0;0
432330 Vila Flores;20;4;0;0;0;24
432335 Vila Lângaro;0;0;0;0;0;0
432340 Vila Maria;15;3;0;0;0;18
432345 Vila Nova do Sul;3376;0;0;0;0;3376
432350 Vista Alegre;0;0;0;0;0;0
432360 Vista Alegre do Prata;0;0;0;0;0;0
432370 Vista Gaúcha;0;0;0;0;0;0
432375 Vitória das Missões;0;0;0;0;0;0
432377 Westfalia;40;0;0;0;0;40
432380 Xangri-lá;0;0;0;0;0;0
500020 Água Clara;0;0;0;0;0;0
500025 Alcinópolis;81;0;0;0;0;81
500060 Amambai;200;25;0;0;0;225
500070 Anastácio;0;0;0;0;0;0
500080 Anaurilândia;0;0;0;0;0;0
500085 Angélica;0;0;0;0;0;0
500090 Antônio João;13;11;0;0;0;24
500100 Aparecida do Taboado;0;0;0;0;0;0
500110 Aquidauana;0;0;0;0;0;0
500124 Aral Moreira;4;0;0;0;0;4
500150 Bandeirantes;0;0;0;0;0;0
500190 Bataguassu;0;0;0;0;0;0
500200 Batayporã;131;101;0;0;0;232
500210 Bela Vista;172;101;0;0;0;273
500215 Bodoquena;40;0;7;0;0;47
500220 Bonito;25032;78719;17712;0;0;121463
500230 Brasilândia;37;0;0;0;0;37
500240 Caarapó;318;208;0;0;0;526
500260 Camapuã;78;36;0;0;0;114
500270 Campo Grande;133954;121978;163426;111125;101967;632450
500280 Caracol;0;0;0;0;0;0
500290 Cassilândia;0;0;0;0;0;0
500295 Chapadão do Sul;108900;134758;148578;72214;89439;553889
500310 Corguinho;0;0;0;0;0;0
500315 Coronel Sapucaia;0;0;0;0;0;0
500320 Corumbá;984;97723;79195;46878;73850;298630
500325 Costa Rica;438;105;0;0;801;1344
500330 Coxim;249;215;0;0;0;464
500345 Deodápolis;121;30;0;0;0;151
500348 Dois Irmãos do Buriti;0;0;0;0;0;0
500350 Douradina;0;2820;4615;0;0;7435
500370 Dourados;1527;44275;38853;9180;14735;108570
500375 Eldorado;0;0;0;0;0;0
500380 Fátima do Sul;178;98;0;0;0;276
500390 Figueirão;0;0;0;0;0;0
500400 Glória de Dourados;0;0;0;0;0;0
500410 Guia Lopes da Laguna;0;0;0;0;0;0
500430 Iguatemi;0;0;0;0;0;0
500440 Inocência;0;0;0;0;0;0
500450 Itaporã;0;0;0;0;0;0
500460 Itaquiraí;0;0;0;0;0;0
500470 Ivinhema;0;0;0;0;0;0
500480 Japorã;0;0;0;0;0;0
500490 Jaraguari;0;0;0;0;0;0
500500 Jardim;0;0;0;0;0;0
500510 Jateí;0;0;0;0;0;0
500515 Juti;89;27;0;0;0;116
500520 Ladário;0;0;3302;6122;20866;30290
500525 Laguna Carapã;60;0;0;0;0;60
500540 Maracaju;5910;3198;140;0;0;9248
500560 Miranda;0;0;0;0;0;0
500568 Mundo Novo;0;0;0;0;0;0
500570 Naviraí;417;294;14;0;0;725
500580 Nioaque;0;0;0;0;0;0
500600 Nova Alvorada do Sul;0;0;0;0;0;0
500620 Nova Andradina;458;295;121;115;0;989
500625 Novo Horizonte do Sul;0;0;0;0;0;0
500627 Paraíso das Águas;0;0;0;0;9440;9440
500630 Paranaíba;0;0;0;0;0;0
500635 Paranhos;0;0;0;0;0;0
500640 Pedro Gomes;1;0;0;0;0;1
500660 Ponta Porã;414;206;0;0;0;620
500690 Porto Murtinho;65;20;0;1;0;86
500710 Ribas do Rio Pardo;38;6;0;0;0;44
500720 Rio Brilhante;0;0;3;0;0;3
500730 Rio Negro;6;0;0;0;0;6
500740 Rio Verde de Mato Grosso;0;0;0;0;0;0
500750 Rochedo;0;0;0;0;0;0
500755 Santa Rita do Pardo;0;0;0;0;0;0
500769 São Gabriel do Oeste;332;17100;70310;41452;18221;147415
500780 Selvíria;0;0;0;0;0;0
500770 Sete Quedas;0;0;0;0;0;0
500790 Sidrolândia;4012;2381;5530;1650;2349;15922
500793 Sonora;122;0;7537;13176;19573;40408
500795 Tacuru;23;0;0;0;0;23
500797 Taquarussu;1309;1306;1242;864;1026;5747
500800 Terenos;0;0;0;0;0;0
500830 Três Lagoas;1212;974;0;0;0;2186
500840 Vicentina;8;4;0;0;0;12
510010 Acorizal;0;0;0;0;0;0
510020 Água Boa;23300;48638;67927;33300;60981;234146
510025 Alta Floresta;106827;92257;75416;13932;43665;332097
510030 Alto Araguaia;49;69;0;8079;9644;17841
510035 Alto Boa Vista;49;707;177;679;500;2112
510040 Alto Garças;710;597;241;163;611;2322
510050 Alto Paraguai;0;0;0;0;0;0
510060 Alto Taquari;63;0;0;1547;4954;6564
510080 Apiacás;31366;35472;41143;23052;21682;152715
510100 Araguaiana;0;0;0;0;0;0
510120 Araguainha;0;0;0;0;0;0
510125 Araputanga;1831;2165;2184;1333;21853;29366
510130 Arenápolis;6778;4470;12952;10459;23570;58229
510140 Aripuanã;0;0;0;0;0;0
510160 Barão de Melgaço;0;0;0;1775;4087;5862
510170 Barra do Bugres;11689;22480;22316;31539;29548;117572
510180 Barra do Garças;40784;66030;69392;32742;39570;248518
510185 Bom Jesus do Araguaia;0;0;0;0;1608;1608
510190 Brasnorte;120;0;0;0;0;120
510250 Cáceres;0;5449;24950;12787;5815;49001
510260 Campinápolis;0;0;0;0;28;28
510263 Campo Novo do Parecis;0;0;39922;41260;52449;133631
510267 Campo Verde;54908;66157;63644;36091;54449;275249
510268 Campos de Júlio;3383;4798;19376;25273;12089;64919
510269 Canabrava do Norte;0;0;3422;4774;9971;18167
510270 Canarana;0;0;12407;23595;36203;72205
510279 Carlinda;27189;38414;48619;32868;38684;185774
510285 Castanheira;33;0;79;73;167;352
510300 Chapada dos Guimarães;28;0;0;0;0;28
510305 Cláudia;83684;224647;144164;85708;27788;565991
510310 Cocalinho;54;0;0;0;0;54
510320 Colíder;162068;178828;138544;62164;76685;618289
510325 Colniza;107;0;0;0;0;107
510330 Comodoro;0;0;0;0;0;0
510335 Confresa;3;4;0;0;0;7
510336 Conquista D'Oeste;2899;4893;23344;16932;21758;69826
510337 Cotriguaçu;6063;6201;6515;7019;5899;31697
510340 Cuiabá;164205;130387;192460;84483;91642;663177
510343 Curvelândia;0;0;0;0;0;0
510345 Denise;0;0;0;0;2464;2464
510350 Diamantino;0;0;12808;25480;21191;59479
510360 Dom Aquino;34;7;0;0;0;41
510370 Feliz Natal;755;23318;18948;2407;1906;47334
510380 Figueirópolis D'Oeste;0;1167;4474;7378;15688;28707
510385 Gaúcha do Norte;3;0;200;0;60;263
510390 General Carneiro;0;0;0;0;0;0
510395 Glória D'Oeste;0;0;0;0;0;0
510410 Guarantã do Norte;33854;35516;100277;66051;77807;313505
510420 Guiratinga;62;0;0;0;7376;7438
510450 Indiavaí;1404;10;82;7489;21429;30414
510452 Ipiranga do Norte;54;55;2092;6568;9386;18155
510454 Itanhangá;49;48;0;5067;2713;7877
510455 Itaúba;8834;23730;25094;14646;14923;87227
510460 Itiquira;21062;18359;13537;14821;16536;84315
510480 Jaciara;7187;1207;20333;26911;25083;80721
510490 Jangada;13;471;20;0;471;975
510500 Jauru;0;10755;13273;4910;5980;34918
510510 Juara;33288;37884;77830;33106;36900;219008
510515 Juína;342;0;0;0;0;342
510517 Juruena;67;3;0;0;0;70
510520 Juscimeira;0;16;12677;17953;14552;45198
510523 Lambari D'Oeste;0;0;0;0;800;800
510525 Lucas do Rio Verde;51158;10716;30280;47521;20289;159964
510530 Luciara;0;0;0;0;0;0
510558 Marcelândia;5674;12370;10351;10952;10650;49997
510560 Matupá;6092;7789;8949;5915;3438;32183
510562 Mirassol d'Oeste;2209;6533;14851;14874;26657;65124
510590 Nobres;0;0;1549;9740;12565;23854
510600 Nortelândia;0;0;0;0;0;0
510610 Nossa Senhora do Livramento;77;32;541;1537;1287;3474
510615 Nova Bandeirantes;4960;479;341;171;5850;11801
510620 Nova Brasilândia;13;0;13307;8762;15830;37912
510621 Nova Canaã do Norte;0;0;10136;25434;33486;69056
510880 Nova Guarita;10808;13836;9538;8843;8185;51210
510618 Nova Lacerda;12385;16135;18044;7997;16310;70871
510885 Nova Marilândia;23;0;0;0;10935;10958
510890 Nova Maringá;0;0;512;632;970;2114
510895 Nova Monte Verde;4262;264;0;0;0;4526
510622 Nova Mutum;377;322;972;1349;10478;13498
510617 Nova Nazaré;0;0;0;0;0;0
510623 Nova Olímpia;36;2;0;912;0;950
510619 Nova Santa Helena;4997;13860;17429;9952;15358;61596
510624 Nova Ubiratã;28;0;4256;9925;17612;31821
510625 Nova Xavantina;65;14;0;0;0;79
510627 Novo Horizonte do Norte;22;0;0;0;41;63
510626 Novo Mundo;19563;23483;41704;21223;31963;137936
510631 Novo Santo Antônio;0;0;0;0;0;0
510628 Novo São Joaquim;403;11252;15826;12367;17106;56954
510629 Paranaíta;7343;9404;61890;17680;8859;105176
510630 Paranatinga;74;121;9082;11253;12974;33504
510637 Pedra Preta;87;0;0;0;0;87
510642 Peixoto de Azevedo;84971;36988;26020;11224;0;159203
510645 Planalto da Serra;0;0;5613;5355;17243;28211
510650 Poconé;0;0;0;0;0;0
510665 Pontal do Araguaia;39;0;0;0;0;39
510670 Ponte Branca;312;418;287;204;180;1401
510675 Pontes e Lacerda;3717;2227;2990;59079;104520;172533
510677 Porto Alegre do Norte;0;0;694;3682;6735;11111
510680 Porto dos Gaúchos;26102;25708;36438;24621;21880;134749
510682 Porto Esperidião;32631;38949;26840;35079;36512;170011
510685 Porto Estrela;0;105;5910;5496;11516;23027
510700 Poxoréo;1423;4645;5766;3023;2495;17352
510704 Primavera do Leste;40276;30796;21635;21445;17082;131234
510706 Querência;12839;1690;248;433;141;15351
510715 Reserva do Cabaçal;0;0;0;0;38;38
510718 Ribeirão Cascalheira;44;42;0;0;0;86
510719 Ribeirãozinho;542;1083;1481;484;667;4257
510720 Rio Branco;0;0;0;0;6583;6583
510757 Rondolândia;0;0;1421;4132;2467;8020
510760 Rondonópolis;2696;2583;26;0;0;5305
510770 Rosário Oeste;0;0;2688;10315;7898;20901
510775 Salto do Céu;0;592;581;236;644;2053
510724 Santa Carmem;98;2660;4648;3503;3590;14499
510774 Santa Cruz do Xingu;0;0;0;0;0;0
510776 Santa Rita do Trivelato;0;0;0;0;0;0
510777 Santa Terezinha;0;0;0;0;0;0
510726 Santo Afonso;975;873;1009;68;8380;11305
510779 Santo Antônio do Leste;3392;3283;30514;24332;29988;91509
510780 Santo Antônio do Leverger;0;0;0;0;0;0
510785 São Félix do Araguaia;0;0;0;0;0;0
510729 São José do Povo;5;0;0;0;0;5
510730 São José do Rio Claro;79059;102268;76142;44411;63648;365528
510735 São José do Xingu;0;247;832;478;747;2304
510710 São José dos Quatro Marcos;0;0;0;0;15473;15473
510740 São Pedro da Cipa;14;0;15;636;1483;2148
510787 Sapezal;0;0;0;0;0;0
510788 Serra Nova Dourada;0;0;0;0;0;0
510790 Sinop;92384;113963;68022;56686;73165;404220
510792 Sorriso;3227;44178;68115;20984;60444;196948
510794 Tabaporã;16496;23136;24784;15050;870;80336
510795 Tangará da Serra;61032;43084;50734;36471;33743;225064
510800 Tapurah;13;935;12234;18198;38129;69509
510805 Terra Nova do Norte;30603;28125;33326;18127;20656;130837
510810 Tesouro;962;1026;1018;688;680;4374
510820 Torixoréu;0;0;0;0;1121;1121
510830 União do Sul;477;1287;1619;7783;11377;22543
510835 Vale de São Domingos;0;1474;15713;12427;12009;41623
510840 Várzea Grande;393;0;0;0;0;393
510850 Vera;0;0;1898;2197;0;4095
510550 Vila Bela da Santíssima Trindade;0;0;2560;13929;25314;41803
510860 Vila Rica;0;0;0;369;899;1268
520005 Abadia de Goiás;0;0;0;0;0;0
520010 Abadiânia;0;0;0;0;0;0
520013 Acreúna;59;0;0;0;0;59
520015 Adelândia;0;0;0;0;0;0
520017 Água Fria de Goiás;11;0;0;0;0;11
520020 Água Limpa;0;0;0;0;0;0
520025 Águas Lindas de Goiás;206;0;0;0;0;206
520030 Alexânia;0;0;0;0;0;0
520050 Aloândia;0;0;0;0;0;0
520055 Alto Horizonte;0;0;0;0;0;0
520060 Alto Paraíso de Goiás;37;0;0;0;0;37
520080 Alvorada do Norte;0;0;0;0;0;0
520082 Amaralina;0;0;0;0;0;0
520085 Americano do Brasil;0;0;0;0;0;0
520090 Amorinópolis;0;0;0;0;0;0
520110 Anápolis;9174;7278;10346;5957;6766;39521
520120 Anhanguera;0;0;0;0;0;0
520130 Anicuns;55;0;0;0;0;55
520140 Aparecida de Goiânia;2207;4931;1853;1949;3435;14375
520145 Aparecida do Rio Doce;0;0;0;0;0;0
520150 Aporé;0;0;0;0;0;0
520160 Araçu;0;0;0;0;0;0
520170 Aragarças;13678;36359;22460;0;0;72497
520180 Aragoiânia;0;0;0;0;0;0
520215 Araguapaz;0;0;0;0;0;0
520235 Arenópolis;0;0;0;0;0;0
520250 Aruanã;0;0;0;0;0;0
520260 Aurilândia;0;0;0;0;0;0
520280 Avelinópolis;0;0;0;0;0;0
520310 Baliza;0;0;0;0;0;0
520320 Barro Alto;4;0;0;0;0;4
520330 Bela Vista de Goiás;0;0;0;0;0;0
520340 Bom Jardim de Goiás;0;0;0;0;0;0
520350 Bom Jesus de Goiás;0;0;0;0;0;0
520355 Bonfinópolis;0;0;0;0;0;0
520357 Bonópolis;0;0;0;0;0;0
520360 Brazabrantes;0;0;0;0;0;0
520380 Britânia;0;0;0;0;0;0
520390 Buriti Alegre;0;0;0;0;0;0
520393 Buriti de Goiás;0;0;0;0;0;0
520396 Buritinópolis;0;0;0;0;0;0
520400 Cabeceiras;0;0;0;0;0;0
520410 Cachoeira Alta;0;77;15;0;0;92
520420 Cachoeira de Goiás;0;0;0;0;0;0
520425 Cachoeira Dourada;0;0;0;0;0;0
520430 Caçu;131;0;0;0;0;131
520440 Caiapônia;28;0;0;0;6086;6114
520450 Caldas Novas;950;1070;705;164;70683;73572
520455 Caldazinha;0;0;0;0;0;0
520460 Campestre de Goiás;0;0;0;0;0;0
520465 Campinaçu;28;0;0;0;0;28
520470 Campinorte;20;46;0;0;0;66
520480 Campo Alegre de Goiás;0;0;0;0;0;0
520485 Campo Limpo de Goiás;0;0;0;0;0;0
520490 Campos Belos;0;0;0;0;0;0
520495 Campos Verdes;0;0;0;0;0;0
520500 Carmo do Rio Verde;0;0;0;0;0;0
520505 Castelândia;24;18;0;0;312;354
520510 Catalão;660;421;0;0;8847;9928
520520 Caturaí;0;0;0;0;0;0
520530 Cavalcante;0;0;0;0;0;0
520540 Ceres;0;0;0;0;0;0
520545 Cezarina;64;32;0;0;0;96
520547 Chapadão do Céu;0;0;0;0;0;0
520549 Cidade Ocidental;818;0;0;0;0;818
520551 Cocalzinho de Goiás;0;0;0;0;196886;196886
520552 Colinas do Sul;33;28;0;0;0;61
520570 Córrego do Ouro;0;0;0;0;0;0
520580 Corumbá de Goiás;0;0;0;0;0;0
520590 Corumbaíba;0;0;0;0;0;0
520620 Cristalina;0;0;0;0;0;0
520630 Cristianópolis;0;0;0;0;123;123
520640 Crixás;0;0;0;0;0;0
520650 Cromínia;0;0;0;0;0;0
520660 Cumari;0;0;0;0;0;0
520670 Damianópolis;0;0;0;0;0;0
520680 Damolândia;0;0;0;0;0;0
520690 Davinópolis;8;1;0;0;0;9
520710 Diorama;0;0;0;0;0;0
520830 Divinópolis de Goiás;0;0;0;0;0;0
520725 Doverlândia;0;0;0;0;0;0
520735 Edealina;29;9;0;0;0;38
520740 Edéia;47;0;0;0;0;47
520750 Estrela do Norte;0;0;0;0;0;0
520753 Faina;0;0;0;0;0;0
520760 Fazenda Nova;0;0;0;0;0;0
520780 Firminópolis;0;0;0;0;0;0
520790 Flores de Goiás;26;0;0;0;0;26
520800 Formosa;0;0;0;0;0;0
520810 Formoso;0;0;0;0;0;0
520815 Gameleira de Goiás;0;0;219;32;0;251
520840 Goianápolis;0;0;0;0;0;0
520850 Goiandira;0;0;0;0;0;0
520860 Goianésia;0;0;0;0;0;0
520870 Goiânia;18214;36417;32371;24292;24628;135922
520880 Goianira;0;0;0;0;0;0
520890 Goiás;46;19;0;0;0;65
520910 Goiatuba;5810;8573;13309;11734;12840;52266
520915 Gouvelândia;27;1;0;0;0;28
520920 Guapó;42;52;0;0;0;94
520929 Guaraíta;0;0;0;0;2726;2726
520940 Guarani de Goiás;0;0;0;0;0;0
520945 Guarinos;0;0;0;0;0;0
520960 Heitoraí;0;0;0;0;0;0
520970 Hidrolândia;0;0;0;0;0;0
520980 Hidrolina;0;0;0;0;0;0
520990 Iaciara;0;0;0;0;0;0
520993 Inaciolândia;36;0;0;0;0;36
520995 Indiara;91;11;0;0;0;102
521000 Inhumas;249;0;0;0;0;249
521010 Ipameri;0;0;0;0;0;0
521015 Ipiranga de Goiás;0;0;0;0;0;0
521020 Iporá;0;0;0;0;0;0
521030 Israelândia;0;0;0;0;0;0
521040 Itaberaí;65;17;0;0;0;82
521056 Itaguari;0;0;0;0;0;0
521060 Itaguaru;3677;3814;2992;3980;0;14463
521080 Itajá;0;0;0;0;0;0
521090 Itapaci;71;7;0;0;0;78
521100 Itapirapuã;0;0;0;0;0;0
521120 Itapuranga;205;78;0;0;0;283
521130 Itarumã;0;0;0;0;0;0
521140 Itauçu;0;0;0;0;0;0
521150 Itumbiara;163;238;1700;1651;2904;6656
521160 Ivolândia;0;0;0;0;0;0
521170 Jandaia;13;6;0;0;0;19
521180 Jaraguá;554;0;0;0;0;554
521190 Jataí;85801;100078;106194;57429;102854;452356
521200 Jaupaci;0;0;0;0;0;0
521205 Jesúpolis;0;0;0;0;0;0
521210 Joviânia;35;5;0;0;0;40
521220 Jussara;22;0;0;0;0;22
521225 Lagoa Santa;0;0;0;0;0;0
521230 Leopoldo de Bulhões;0;0;0;0;0;0
521250 Luziânia;1369;3016;3169;1829;2353;11736
521260 Mairipotaba;18;0;0;0;0;18
521270 Mambaí;0;0;0;0;0;0
521280 Mara Rosa;0;0;0;0;0;0
521290 Marzagão;0;0;0;0;0;0
521295 Matrinchã;0;0;0;0;0;0
521300 Maurilândia;0;0;0;0;0;0
521305 Mimoso de Goiás;0;0;0;0;0;0
521308 Minaçu;188;0;0;0;0;188
521310 Mineiros;288;251;0;0;0;539
521340 Moiporá;0;0;0;0;0;0
521350 Monte Alegre de Goiás;0;0;0;0;0;0
521370 Montes Claros de Goiás;6;0;0;0;0;6
521375 Montividiu;0;0;0;0;693;693
521377 Montividiu do Norte;4;2;0;0;0;6
521380 Morrinhos;287;69;0;0;0;356
521385 Morro Agudo de Goiás;0;0;0;0;0;0
521390 Mossâmedes;0;0;0;0;0;0
521400 Mozarlândia;0;0;0;0;0;0
521405 Mundo Novo;0;0;0;0;0;0
521410 Mutunópolis;0;0;0;0;0;0
521440 Nazário;0;23;0;0;0;23
521450 Nerópolis;74;26;0;0;0;100
521460 Niquelândia;24;48;0;0;0;72
521470 Nova América;0;0;0;0;0;0
521480 Nova Aurora;11;2;0;0;0;13
521483 Nova Crixás;0;0;0;0;0;0
521486 Nova Glória;17;25;0;0;0;42
521487 Nova Iguaçu de Goiás;0;0;0;0;0;0
521490 Nova Roma;0;0;0;0;0;0
521500 Nova Veneza;31;4;0;0;0;35
521520 Novo Brasil;0;0;0;0;0;0
521523 Novo Gama;0;0;0;0;0;0
521525 Novo Planalto;0;0;0;0;0;0
521530 Orizona;0;0;0;0;0;0
521540 Ouro Verde de Goiás;0;0;0;0;0;0
521550 Ouvidor;0;0;0;0;0;0
521560 Padre Bernardo;0;0;0;0;0;0
521565 Palestina de Goiás;0;0;0;0;0;0
521570 Palmeiras de Goiás;0;0;0;0;0;0
521580 Palmelo;5114;11081;5346;1558;8402;31501
521590 Palminópolis;19;0;0;0;0;19
521600 Panamá;0;0;0;0;0;0
521630 Paranaiguara;0;0;0;0;0;0
521640 Paraúna;52;13;0;0;0;65
521645 Perolândia;0;0;0;0;2152;2152
521680 Petrolina de Goiás;0;0;0;0;0;0
521690 Pilar de Goiás;0;0;0;0;0;0
521710 Piracanjuba;0;0;0;0;0;0
521720 Piranhas;7;0;0;0;0;7
521730 Pirenópolis;0;0;0;0;0;0
521740 Pires do Rio;34147;32466;40887;29644;23056;160200
521760 Planaltina;0;0;0;0;0;0
521770 Pontalina;16;6;0;0;0;22
521800 Porangatu;72;283;0;0;0;355
521805 Porteirão;0;0;0;0;473;473
521810 Portelândia;0;0;0;0;0;0
521830 Posse;0;0;1996;7235;7583;16814
521839 Professor Jamil;10;0;0;0;0;10
521850 Quirinópolis;36;0;0;17263;81922;99221
521860 Rialma;0;0;0;0;0;0
521870 Rianápolis;9;7;0;0;0;16
521878 Rio Quente;0;0;0;0;0;0
521880 Rio Verde;30425;30214;33799;18156;21130;133724
521890 Rubiataba;105;23;0;0;0;128
521900 Sanclerlândia;0;0;0;0;0;0
521910 Santa Bárbara de Goiás;58;61;0;0;0;119
521920 Santa Cruz de Goiás;11;1648;10444;10573;12433;35109
521925 Santa Fé de Goiás;0;0;0;0;0;0
521930 Santa Helena de Goiás;0;0;27238;46691;32091;106020
521935 Santa Isabel;0;0;0;0;0;0
521940 Santa Rita do Araguaia;0;0;0;0;0;0
521945 Santa Rita do Novo Destino;22;3;0;0;0;25
521950 Santa Rosa de Goiás;11;0;0;0;0;11
521960 Santa Tereza de Goiás;0;0;0;0;0;0
521970 Santa Terezinha de Goiás;0;0;0;0;0;0
521971 Santo Antônio da Barra;0;0;0;0;0;0
521973 Santo Antônio de Goiás;0;0;0;0;0;0
521975 Santo Antônio do Descoberto;0;0;0;0;0;0
521980 São Domingos;0;0;0;0;0;0
521990 São Francisco de Goiás;0;0;0;0;0;0
522000 São João d'Aliança;56;0;0;0;0;56
522005 São João da Paraúna;1;0;0;0;0;1
522010 São Luís de Montes Belos;0;43;0;0;0;43
522015 São Luíz do Norte;0;0;0;0;0;0
522020 São Miguel do Araguaia;0;0;0;0;0;0
522026 São Miguel do Passa Quatro;0;0;0;0;0;0
522028 São Patrício;0;0;0;0;0;0
522040 São Simão;19;70;0;0;0;89
522045 Senador Canedo;135;294;285;487;165;1366
522050 Serranópolis;36;0;0;38;0;74
522060 Silvânia;0;0;0;0;0;0
522068 Simolândia;0;0;0;0;0;0
522070 Sítio d'Abadia;0;0;0;0;0;0
522100 Taquaral de Goiás;0;0;0;0;0;0
522108 Teresina de Goiás;0;0;0;0;0;0
522119 Terezópolis de Goiás;0;0;0;0;0;0
522130 Três Ranchos;0;0;0;0;0;0
522140 Trindade;953;302;66;43;59;1423
522145 Trombas;13;0;0;0;0;13
522150 Turvânia;14;0;0;0;0;14
522155 Turvelândia;0;0;0;0;0;0
522157 Uirapuru;0;0;0;0;0;0
522160 Uruaçu;217;256;0;0;0;473
522170 Uruana;0;0;0;0;0;0
522180 Urutaí;0;0;0;0;0;0
522185 Valparaíso de Goiás;21;44;0;0;0;65
522190 Varjão;0;0;0;0;0;0
522200 Vianópolis;0;0;0;0;0;0
522205 Vicentinópolis;0;0;0;0;0;0
522220 Vila Boa;0;0;0;0;0;0
522230 Vila Propício;17;0;0;0;0;17
530010 Brasília;53569;25892;45759;15613;2063;142896
Total;29649804;33224787;38422838;27909405;39114128;168320962